ADDACC|Add Access Code|2
ADDAJE|Add Autostart Job Entry|2
ADDALRACNE|Add Alert Action Entry|2
ADDALRD|Add Alert Description|2
ADDALRSLTE|Add Alert Selection Entry|2
ADDASPCPYD|Add ASP Copy Description|2
ADDAUTLE|Add Authorization List Entry|2
ADDBKP|Add Breakpoint|2
ADDBNDDIRE|Add Binding Directory Entry|2
ADDCADMRE|Add Cluster Administrative Domain Managed Resource Entry|2
ADDCADNODE|Add Cluster Administrative Domain Node Entry|2
ADDCCSCLT|Add Change Control Server Client|2
ADDCFGLE|Add Configuration List Entries|2
ADDCICSCVT|Add CICS CVT Entry|2
ADDCICSDCT|Add CICS DCT Entry|2
ADDCICSFCT|Add CICS FCT Entry|2
ADDCICSGLT|Add CICS GLT Entry|2
ADDCICSJCT|Add CICS JCT Entry|2
ADDCICSPCT|Add CICS PCT Entry|2
ADDCICSPPT|Add CICS PPT Entry|2
ADDCICSSIT|Add CICS SIT Entry|2
ADDCICSTCS|Add CICS TCS Entry|2
ADDCICSTCT|Add CICS TCT Entry|2
ADDCICSTST|Add CICS TST Entry|2
ADDCKMKSFE|Add Crytographic Key Management Keystore File Entry|2
ADDCLUMON|Add Cluster Monitor|2
ADDCLUNODE|Add Cluster Node Entry|2
ADDCMDCRQA|Add Command Change Request Activity|2
ADDCMNE|Add Communications Entry|2
ADDCOMSNMP|Add Community for SNMP|2
ADDCRGDEVE|Add Cluster Resource Group Device Entry|2
ADDCRGNODE|Add Cluster Resource Group Node Entry|2
ADDCRQA|Add Change Request Activity|2
ADDDEVDMNE|Add Device Domain Entry|2
ADDDIRE|Add Directory Entry|2
ADDDIRINST|Add Directory Server Instance|2
ADDDIRSHD|Add Directory Shadow System|2
ADDDLOAUT|Add Document Library Object Authority|2
ADDDNSSIG|Add Domain Name System Signature|2
ADDDPRREG|Add DataPropagator Registration|2
ADDDPRSUB|Add DataPropagator Subscription|2
ADDDPRSUBM|Add DataPropagator Subscription Member|2
ADDDSTCLGE|Add Distribution Catalog Entry|2
ADDDSTLE|Add Distribution List Entry|2
ADDDSTQ|Add Distribution Queue|2
ADDDSTRTE|Add Distribution Route|2
ADDDSTSYSN|Add Secondary System Name|2
ADDDTADFN|Add Data Definition|2
ADDDWDFN|Add Disk Watcher Definition|2
ADDEMLCFGE|Add Configuration Entry|2
ADDENVVAR|Add Environment Variable|2
ADDEWCBCDE|Add Wireless Controller Barcode Entry|2
ADDEWCM|Add Wireless Controller Member|2
ADDEWCPTCE|Add Wireless Controller PTC Entry|2
ADDEWLM|Add Wireless Line Member|2
ADDEXITPGM|Add Exit Program|2
ADDFCTE|Add Forms Control Entry|2
ADDFNTTBLE|Add Font Table Entry|2
ADDHACFGD|Add HA Configuration Description|2
ADDHDBDLFM|Add Host Database to DataLink File Manager|2
ADDHYSSTGD|Add HyperSwap Storage Description|2
ADDICFDEVE|Add Intersystem Communications Function Device Entry|2
ADDIMGCLGE|Add Image Catalog Entry|2
ADDIPSIFC|Add IP over SNA Interface|2
ADDIPSLOC|Add IP over SNA Location|2
ADDIPSRTE|Add IP over SNA Route|2
ADDJOBJS|Add Job using Advanced Job Scheduler|2
ADDJOBQE|Add Job Queue Entry|2
ADDJOBSCDE|Add Job Schedule Entry|2
ADDJWDFN|Add Job Watcher Definition|2
ADDKRBKTE|Add Kerberos Keytab Entry|2
ADDKRBTKT|Add Kerberos Ticket|2
ADDLANADPI|Add LAN Adapter Information|2
ADDLFM|Add Logical File Member|2
ADDLIBLE|Add Library List Entry|2
ADDLICCRQA|Add License Change Request Activity|2
ADDLICKEY|Add License Key Information|2
ADDLNK|Add Link|2
ADDMEDBRM|Add Media to BRMS|2
ADDMEDIBRM|Add Media Information to BRMS|2
ADDMFS|Add Mounted File System|2
ADDMLMBRM|Add Media Library Media to BRMS|2
ADDMSGD|Add Message Description|2
ADDMSTPART|Add Master Key Part|2
ADDNCK|Add Nickname|2
ADDNETJOBE|Add Network Job Entry|2
ADDNETTBLE|Add Network Table Entry|2
ADDNODLE|Add Node List Entry|2
ADDNWSSTGL|Add Server Storage Link|2
ADDOBJCRQA|Add Object Change Request Activity|2
ADDOPTCTG|Add Optical Cartridge|2
ADDOPTSVR|Add Optical Server|2
ADDOSPFARA|Add OSPF Area|2
ADDOSPFIFC|Add OSPF Interface|2
ADDOSPFLNK|Add OSPF Virtual Link|2
ADDOSPFRNG|Add OSPF Range|2
ADDPCLTBLE|Add Protocol Table Entry|2
ADDPEXDFN|Add Performance Explorer Definition|2
ADDPEXFTR|Add Performance Explorer Filter|2
ADDPFCST|Add Physical File Constraint|2
ADDPFM|Add Physical File Member|2
ADDPFTRG|Add Physical File Trigger|2
ADDPFVLM|Add Physical File Variable Length Member|2
ADDPFXDLFM|Add Prefix to DataLink File Manager|2
ADDPGM|Add Program|2
ADDPJE|Add Prestart Job Entry|2
ADDPRBACNE|Add Problem Action Entry|2
ADDPRBSLTE|Add Problem Selection Entry|2
ADDPRDCRQA|Add Product Change Request Activity|2
ADDPRDLICI|Add License Information|2
ADDPTFCRQA|Add PTF Change Request Activity|2
ADDRDBDIRE|Add Relational Database Directory Entry|2
ADDREXBUF|Add REXX Buffer|2
ADDRIPACP|Add Routing Information Protocol Accepted Route|2
ADDRIPFLT|Add Routing Information Protocol Filter|2
ADDRIPIFC|Add Routing Information Protocol Interface|2
ADDRIPIGN|Add Ignored Routing Information Protocol Neighbor|2
ADDRJECMNE|Add RJE Communication Entry|2
ADDRJERDRE|Add RJE Reader Entry|2
ADDRJEWTRE|Add RJE Writer Entry|2
ADDRMTDFN|Add Remote Definition|2
ADDRMTJRN|Add Remote Journal|2
ADDRPTOND|Add Report|2
ADDRPYLE|Add Reply List Entry|2
ADDRSCCRQA|Add Resource Change Request Activity|2
ADDRTGE|Add Routing Entry|2
ADDSCHIDXE|Add Search Index Entry|2
ADDSMTPLE|Add SMTP List Entry|2
ADDSOCE|Add Sphere of Control Entry|2
ADDSRVTBLE|Add Service Table Entry|2
ADDSVCCPYD|Add SAN Volume Controller ASP Copy Description|2
ADDSVRAUTE|Add Server Authentication Entry|2
ADDTAPCTG|Add Tape Cartridge|2
ADDTCPHTE|Add TCP/IP Host Table Entry|2
ADDTCPIFC|Add TCP/IP Interface|2
ADDTCPPORT|Add TCP/IP Port Restriction|2
ADDTCPPTP|Add TCP/IP Point-to-Point Profile|2
ADDTCPRSI|Add TCP/IP Remote System|2
ADDTCPRTE|Add TCP/IP Route|2
ADDTCPSVR|Add TCP/IP Server|2
ADDTRC|Add Trace|2
ADDTRCFTR|Add Trace Filter|2
ADDUSRSMTP|Add User SMTP|2
ADDUSRSNMP|Add User for SNMP|2
ADDWLCGRP|Add Workload Group|2
ADDWLCPRDE|Add Workload Product Entry|2
ADDWSE|Add Work Station Entry|2
ALCOBJ|Allocate Object|2
ANSLIN|Answer Line|2
ANSQST|Answer Questions|2
ANZCMDPFR|Analyze Command Performance|2
ANZDBF|Analyze Database Files|2
ANZDBFKEY|Analyze Database File Keys|2
ANZDFTPWD|Analyze Default Passwords|2
ANZDPRJRN|Analyze DataPropagator Journaling|2
ANZLIBBRM|Analyze Libraries using BRMS|2
ANZOBJCVN|Analyze Object Conversion|2
ANZPFRDTA|Analyze Performance Data|2
ANZPGM|Analyze Programs|2
ANZPRB|Analyze Problem|2
ANZPRFACT|Analyze Profile Activity|2
ANZQRY|Analyze Query|2
ANZUSROBJ|Analyze User Objects|2
APING|Verify APPC Connection|2
APYJRNCHG|Apply Journaled Changes|2
APYJRNCHGX|Apply Journaled Changes Extend|2
APYPTF|Apply Program Temporary Fix|2
APYRMTPTF|Apply Remote Program Temporary Fix|2
AREXEC|Run Remote Command|2
ARPING|Send Address Resolution Protocol Request|2
ASKQST|Ask Question|2
BCHJOB|Batch Job|2
CALL|Call Program|2
CALLPRC|Call Bound Procedure|2
CALLSUBR|Call Subroutine|2
CD|Change Current Directory|2
CFGACCWEB|Configure Access for Web|2
CFGACCWEB2|Configure Access for Web|2
CFGDEVASP|Configure ASP Device|2
CFGDEVMLB|Configure Device Media Library|2
CFGDSTSRV|Configure Distribution Service|2
CFGGEOMIR|Configure Geographic Mirror|2
CFGIPS|Configure IP over SNA|2
CFGPFRCOL|Configure Performance Collection|2
CFGPM400|Configure PM/400|2
CFGPMAGT|Configure PM Agent|2
CFGRPDS|Configure VM/MVS Bridge|2
CFGRTG|Configure Routing Protocols|2
CFGSYSSEC|Configure System Security|2
CFGTCP|Configure TCP/IP|2
CFGTCPAPP|Configure TCP/IP Applications|2
CFGTCPBP|Configure TCP/IP BOOTP|2
CFGTCPFTP|Configure TCP/IP FTP|2
CFGTCPHTTP|Configure TCP/IP HTTP|2
CFGTCPLPD|Configure TCP/IP LPD|2
CFGTCPPTP|Configure Point-to-Point TCP/IP|2
CFGTCPRTD|Configure TCP/IP RouteD|2
CFGTCPRXC|Configure TCP/IP REXEC|2
CFGTCPSMTP|Configure TCP/IP SMTP|2
CFGTCPSNMP|Configure TCP/IP SNMP|2
CFGTCPTELN|Configure TCP/IP TELNET|2
CHDIR|Change Current Directory|2
CHGACGCDE|Change Accounting Code|2
CHGACTPRFL|Change Active Profile List|2
CHGACTSCDE|Change Activation Schedule Entry|2
CHGAJE|Change Autostart Job Entry|2
CHGALRACNE|Change Alert Action Entry|2
CHGALRD|Change Alert Description|2
CHGALRSLTE|Change Alert Selection Entry|2
CHGALRTBL|Change Alert Table|2
CHGAMTDFT|Change Application Management Toolset Defaults|2
CHGASPA|Change Auxiliary Storage Pool Attribute|2
CHGASPACT|Change ASP Activity|2
CHGASPCPYD|Change ASP Copy Description|2
CHGASPSSN|Change ASP Session|2
CHGATR|Change Attribute|2
CHGAUD|Change Auditing Value|2
CHGAUT|Change Authority|2
CHGAUTJS|Change Job Authority using Advanced Job Scheduler|2
CHGAUTLE|Change Authorization List Entry|2
CHGBCKUP|Change Backup Options|2
CHGBPA|Change BOOTP Attributes|2
CHGCAD|Change Cluster Administrative Domain|2
CHGCCSA|Change Change Control Server Attributes|2
CHGCDEFNT|Change Coded Font|2
CHGCFGL|Change Configuration List|2
CHGCFGLE|Change Configuration List Entries|2
CHGCICSCVT|Change CICS CVT Entry|2
CHGCICSDCT|Change CICS DCT Entry|2
CHGCICSFCT|Change CICS FCT Entry|2
CHGCICSGRP|Change CICS Group|2
CHGCICSJCT|Change CICS JCT Entry|2
CHGCICSPCT|Change CICS PCT Entry|2
CHGCICSPPT|Change CICS PPT Entry|2
CHGCICSSIT|Change CICS SIT Entry|2
CHGCICSSTS|Change CICS Status|2
CHGCICSTCS|Change CICS TCS Entry|2
CHGCICSTCT|Change CICS TCT Entry|2
CHGCICSTST|Change CICS TST Entry|2
CHGCLNUP|Change Cleanup|2
CHGCLS|Change Class|2
CHGCLU|Change Cluster Configuration|2
CHGCLUMON|Change Cluster Monitor|2
CHGCLUNODE|Change Cluster Node Entry|2
CHGCLURCY|Change Cluster Recovery|2
CHGCLUVER|Change Cluster Version|2
CHGCMD|Change Command|2
CHGCMDCRQA|Change Command Change Request Activity|2
CHGCMDDFT|Change Command Default|2
CHGCMNE|Change Communications Entry|2
CHGCNTINF|Change Contact Information|2
CHGCOMSNMP|Change Community for SNMP|2
CHGCOSD|Change Class-of-Service Description|2
CHGCRG|Change Cluster Resource Group|2
CHGCRGDEVE|Change Cluster Resource Group Device Entry|2
CHGCRGPRI|Change Cluster Resource Group Primary|2
CHGCRQA|Change Change Request Activity|2
CHGCRQD|Change Change Request Description|2
CHGCSI|Change Communications Side Information|2
CHGCTLAPPC|Change Controller Description APPC|2
CHGCTLASC|Change Controller Description Async|2
CHGCTLBSC|Change Controller Description BSC|2
CHGCTLFNC|Change Controller Description Finance|2
CHGCTLHOST|Change Controller Description SNA Host|2
CHGCTLLWS|Change Controller Description Local WS|2
CHGCTLNET|Change Controller Description Network|2
CHGCTLRTL|Change Controller Description Retail|2
CHGCTLRWS|Change Controller Description Remote WS|2
CHGCTLTAP|Change Controller Description Tape|2
CHGCTLVWS|Change Controller Description Virtual WS|2
CHGCURDIR|Change Current Directory|2
CHGCURLIB|Change Current Library|2
CHGDBG|Change Debug|2
CHGDDMF|Change Distributed Data Management File|2
CHGDDMTCPA|Change Distributed Data Management TCP/IP Attributes|2
CHGDEVAPPC|Change Device Description APPC|2
CHGDEVASC|Change Device Description Async|2
CHGDEVASP|Change Device Description ASP|2
CHGDEVBSC|Change Device Description BSC|2
CHGDEVCRP|Change Device Description Crypto|2
CHGDEVDSP|Change Device Description Display|2
CHGDEVFNC|Change Device Description Finance|2
CHGDEVHOST|Change Device Description SNA Host|2
CHGDEVINTR|Change Device Description Intra|2
CHGDEVMLB|Change Device Description Media Lib|2
CHGDEVNET|Change Device Description Network|2
CHGDEVNWSH|Change Device Description NWSH|2
CHGDEVOPT|Change Device Description Optical|2
CHGDEVPRT|Change Device Description Printer|2
CHGDEVRTL|Change Device Description Retail|2
CHGDEVSNPT|Change Device Description SNPT|2
CHGDEVSNUF|Change Device Description SNUF|2
CHGDEVTAP|Change Device Description Tape|2
CHGDHCPA|Change Dynamic Host Configuration Protocol Attributes|2
CHGDHCPSVR|Change Dynamic Host Configuration Protocol Server|2
CHGDIRE|Change Directory Entry|2
CHGDIRSHD|Change Directory Shadow System|2
CHGDIRSVRA|Change Directory Server Attributes|2
CHGDLJS|Change Data Library using Advanced Job Scheduler|2
CHGDLOAUD|Change Document Library Object Auditing Level|2
CHGDLOAUT|Change Document Library Object Authority|2
CHGDLOOWN|Change Document Library Object Owner|2
CHGDLOPGP|Change Document Library Object Primary Group|2
CHGDNSA|Change Domain Name System Server Attributes|2
CHGDOCD|Change Document Description|2
CHGDSPF|Change Display File|2
CHGDSTA|Change Distribution Attributes|2
CHGDSTD|Change Distribution|2
CHGDSTL|Change Distribution List|2
CHGDSTPWD|Change IBM Service Tools Password|2
CHGDSTQ|Change Distribution Queue|2
CHGDSTRTE|Change Distribution Route|2
CHGDTA|Change Data|2
CHGDTAARA|Change Data Area|2
CHGDTAJS|Change Parameter Data|2
CHGEMLCFGE|Change Configuration Entry|2
CHGENVVAR|Change Environment Variable|2
CHGEWCBCDE|Change Wireless Controller Barcode Entry|2
CHGEWCM|Change Wireless Controller Member|2
CHGEWCPTCE|Change Wireless Controller PTC Entry|2
CHGEWLM|Change Wireless Line Member|2
CHGEXPSCDE|Change Expiration Schedule Entry|2
CHGFCNARA|Change Functional Area|2
CHGFCNUSG|Change Function Usage|2
CHGFCT|Change Forms Control Table|2
CHGFCTE|Change Forms Control Entry|2
CHGFNTRSC|Change Font Resource|2
CHGFNTTBLE|Change Font Table Entry|2
CHGFTPA|Change FTP Attributes|2
CHGFTR|Change Filter|2
CHGGPHFMT|Change Graph Format|2
CHGGPHPKG|Change Graph Package|2
CHGGRPA|Change Group Attributes|2
CHGHACFGD|Change HA Configuration Description) |2
CHGHLLPTR|Change High-Level Language Pointer|2
CHGHTTPA|Change HTTP Attributes|2
CHGHYSSTGD|Change HyperSwap Storage Description|2
CHGHYSSTS|Change HyperSwap Status|2
CHGICFDEVE|Change Intersystem Communications Function Device Entry|2
CHGICFF|Change Intersystem Communications Function File|2
CHGIMGCLG|Change Image Catalog|2
CHGIMGCLGE|Change Image Catalog Entry|2
CHGIPLA|Change IPL Attributes|2
CHGIPSIFC|Change IP over SNA Interface|2
CHGIPSLOC|Change IP over SNA Location|2
CHGIPSTOS|Change IP over SNA Type of Service|2
CHGJOB|Change Job|2
CHGJOBD|Change Job Description|2
CHGJOBJS|Change Job using Advanced Job Scheduler|2
CHGJOBMLBA|Change Job Media Library Attributes|2
CHGJOBQ|Change Job Queue|2
CHGJOBQE|Change Job Queue Entry|2
CHGJOBSCDE|Change Job Schedule Entry|2
CHGJOBTYP|Change Job Type|2
CHGJRN|Change Journal|2
CHGJRNA|Change Journal Attributes|2
CHGJRNOBJ|Change Journaled Object|2
CHGKBDMAP|Change Keyboard Map|2
CHGKRBPWD|Change Kerberos Password|2
CHGLANADPI|Change LAN Adapter Information|2
CHGLF|Change Logical File|2
CHGLFM|Change Logical File Member|2
CHGLIB|Change Library|2
CHGLIBL|Change Library List|2
CHGLICCRQA|Change License Change Request Activity|2
CHGLICINF|Change License Information|2
CHGLINASC|Change Line Description Async|2
CHGLINBSC|Change Line Description BSC|2
CHGLINDDI|Change Line Description DDI|2
CHGLINETH|Change Line Description Ethernet|2
CHGLINFAX|Change Line Description Fax|2
CHGLINFR|Change Line Description Frame Relay|2
CHGLINPPP|Change Line Description PPP|2
CHGLINSDLC|Change Line Description SDLC|2
CHGLINTDLC|Change Line Description TDLC|2
CHGLINTRN|Change Line Description Token-Ring|2
CHGLINWLS|Change Line Description Wireless|2
CHGLINX25|Change Line Description X.25|2
CHGLNKLBRM|Change Link List|2
CHGLPDA|Change LPD Attributes|2
CHGMEDBRM|Change Media using BRMS|2
CHGMGDSYSA|Change Managed System Attributes|2
CHGMGRSRVA|Change Manager Services Attributes|2
CHGMGTCOL|Change Management Collection|2
CHGMNU|Change Menu|2
CHGMOD|Change Module|2
CHGMODD|Change Mode Description|2
CHGMSGD|Change Message Description|2
CHGMSGF|Change Message File|2
CHGMSGQ|Change Message Queue|2
CHGNCK|Change Nickname|2
CHGNETA|Change Network Attributes|2
CHGNETJOBE|Change Network Job Entry|2
CHGNFSEXP|Change Network File System Export|2
CHGNFYJS|Change Notification Command using Advanced Job Scheduler|2
CHGNODGRPA|Change Node Group Attributes|2
CHGNTBD|Change NetBIOS Description|2
CHGNTPA|Change Network Time Protocol Attributes|2
CHGNWIFR|Change Network Interface Frame-Relay Network|2
CHGNWSA|Change Network Server Attributes|2
CHGNWSCFG|Change Network Server Configuration|2
CHGNWSD|Change Network Server Description|2
CHGNWSSTG|Change Network Server Storage Space|2
CHGNWSUSRA|Change Network Server User Attributes|2
CHGOBJAUD|Change Object Auditing|2
CHGOBJCRQA|Change Object Change Request Activity|2
CHGOBJD|Change Object Description|2
CHGOBJOWN|Change Object Owner|2
CHGOBJPGP|Change Object Primary Group|2
CHGOPTA|Change Optical Attributes|2
CHGOPTVOL|Change Optical Volume|2
CHGOSPFA|Change OSPF Attributes|2
CHGOSPFARA|Change OSPF Area|2
CHGOSPFIFC|Change OSPF Interface|2
CHGOSPFLNK|Change OSPF Virtual Link|2
CHGOSPFRNG|Change OSPF Range|2
CHGOUTQ|Change Output Queue|2
CHGOWN|Change Owner|2
CHGPCOPRF|Change PC Organizer Profile|2
CHGPDGPRF|Change Print Descriptor Group Profile|2
CHGPDMDFT|Change Programming Development Manager Defaults|2
CHGPEXDFN|Change Performance Explorer Definition|2
CHGPF|Change Physical File|2
CHGPFCST|Change Physical File Constraint|2
CHGPFM|Change Physical File Member|2
CHGPFTRG|Change Physical File Trigger|2
CHGPGM|Change Program|2
CHGPGMVAR|Change Program Variable|2
CHGPGP|Change Primary Group|2
CHGPGRJS|Change Pager Command using Advanced Job Scheduler|2
CHGPJ|Change Prestart Job|2
CHGPJE|Change Prestart Job Entry|2
CHGPLDOND|Change Policy Level Date|2
CHGPOPA|Change POP Server Attributes|2
CHGPRB|Change Problem|2
CHGPRBACNE|Change Problem Action Entry|2
CHGPRBSLTE|Change Problem Selection Entry|2
CHGPRDCRQA|Change Product Change Request Activity|2
CHGPRDOBJD|Change Product Object Description|2
CHGPRF|Change Profile|2
CHGPRTF|Change Printer File|2
CHGPRXCMD|Change Proxy Command|2
CHGPSFCFG|Change Print Services Facility Configuration|2
CHGPTFCRQA|Change PTF Change Request Activity|2
CHGPTR|Change Pointer|2
CHGPWD|Change Password|2
CHGPWRSCD|Change Power On/Off Schedule|2
CHGPWRSCDE|Change Power Schedule Entry|2
CHGQRYA|Change Query Attributes|2
CHGQSTDB|Change Question/Answer Database|2
CHGRCYAP|Change Recovery for Access Paths|2
CHGRDBDIRE|Change Relational Database Directory Entry|2
CHGRIPA|Change Routing Information Protocol Attributes|2
CHGRIPFLT|Change Routing Information Protocol Filter|2
CHGRIPIFC|Change Routing Information Protocol Interface|2
CHGRJECMNE|Change RJE Communication Entry|2
CHGRJERDRE|Change RJE Reader Entry|2
CHGRJEWTRE|Change RJE Writer Entry|2
CHGRMTDFN|Change Remote Definition|2
CHGRMTJRN|Change Remote Journal|2
CHGRPYLE|Change Reply List Entry|2
CHGRSCCRQA|Change Resource Change Request Activity|2
CHGRTDA|Change RouteD Attributes|2
CHGRTGE|Change Routing Entry|2
CHGRWSPWD|Change Remote Workstation Controller Password|2
CHGRXCA|Change REXEC Attributes|2
CHGS36|Change S/36 Configuration|2
CHGS36A|Change S/36 Environment Attributes|2
CHGS36MSGL|Change S/36 Message List|2
CHGS36PGMA|Change S/36 Program Attributes|2
CHGS36PRCA|Change S/36 Proc Attributes|2
CHGS36SRCA|Change S/36 Source Attributes|2
CHGSAVF|Change Save File|2
CHGSBSD|Change Subsystem Description|2
CHGSCDBRM|Change Job Scheduler|2
CHGSCHIDX|Change Search Index|2
CHGSECA|Change Security Attributes|2
CHGSECAUD|Change Security Auditing|2
CHGSHRPOOL|Change Shared Storage Pool|2
CHGSMTPA|Change SMTP Attributes|2
CHGSNMPA|Change SNMP Attributes|2
CHGSPLFA|Change Spooled File Attributes|2
CHGSRCPF|Change Source Physical File|2
CHGSRVA|Change Service Attributes|2
CHGSRVAGT|Change Service Agent|2
CHGSRVAGTA|Change Service Agent Attributes|2
CHGSRVCFG|Change Service Configuration|2
CHGSRVPGM|Change Service Program|2
CHGSRVPVDA|Change Service Provider Attributes|2
CHGSSND|Change Session Description|2
CHGSSNMAX|Change Session Maximum|2
CHGSVCCPYD|Change SAN Volume Controller ASP Copy Description|2
CHGSVCSSN|Change SAN Volume Controller ASP Session|2
CHGSVRAUTE|Change Server Authentication Entry|2
CHGSYSDIRA|Change System Directory Attributes|2
CHGSYSJOB|Change System Job|2
CHGSYSLIBL|Change System Library List|2
CHGSYSVAL|Change System Value|2
CHGTAPCTG|Change Tape Cartridge|2
CHGTAPF|Change Tape File|2
CHGTCPA|Change TCP/IP Attributes|2
CHGTCPDMN|Change TCP/IP Domain|2
CHGTCPHTE|Change TCP/IP Host Table Entry|2
CHGTCPIFC|Change TCP/IP Interface|2
CHGTCPRTE|Change TCP/IP Route|2
CHGTCPSVR|Change TCP/IP Server|2
CHGTELNA|Change TELNET Attributes|2
CHGTFTPA|Change TFTP Attributes|2
CHGTIMZON|Change Time Zone Description|2
CHGUSRAUD|Change User Auditing|2
CHGUSRPRF|Change User Profile|2
CHGUSRPRTI|Change User Print Information|2
CHGUSRSMTP|Change User SMTP|2
CHGUSRSNMP|Change User for SNMP|2
CHGUSRTRC|Change User Trace|2
CHGVAR|Change Variable|2
CHGVTMAP|Change VT Keyboard Map|2
CHGWLCGRP|Change Workload Group|2
CHGWSE|Change Work Station Entry|2
CHGWTR|Change Writer|2
CHKASPBAL|Check Auxiliary Storage Pool Balance|2
CHKCMNTRC|Check Communications Trace|2
CHKDLO|Check Document Library Object|2
CHKDNSCFG|Check Domain Name System Configuration|2
CHKDNSZNE|Check Domain Name System Zone|2
CHKEXPBRM|Check Expired Media for BRMS|2
CHKIGCTBL|Check DBCS Font Table|2
CHKIN|Check In Object|2
CHKMSTKVV|Check Master Key Verification Value|2
CHKOBJ|Check Object|2
CHKOBJITG|Check Object Integrity|2
CHKOPTVOL|Check Optical Volume|2
CHKOUT|Check Out Object|2
CHKPFRCOL|Check Performance Collection|2
CHKPRDOPT|Check Product Option|2
CHKPWD|Check Password|2
CHKRCDLCK|Check Record Locks|2
CHKTAP|Check Tape|2
CLOF|Close File|2
CLOSE|Close Database File|2
CLRJOBQ|Clear Job Queue|2
CLRLIB|Clear Library|2
CLRMSGQ|Clear Message Queue|2
CLRMSTKEY|Clear Master Key|2
CLROUTQ|Clear Output Queue|2
CLRPFM|Clear Physical File Member|2
CLRPOOL|Clear Pool|2
CLRSAVF|Clear Save File|2
CLRSVRSEC|Clear Server Security Data|2
CLRTRCDTA|Clear Trace Data|2
CMD|Command Definition|2
CMPJRNIMG|Compare Journal Images|2
CMPPFM|Compare Physical File Member|2
CNLRJERDR|Cancel RJE Reader|2
CNLRJEWTR|Cancel RJE Writer|2
COMMIT|Commit|2
COPY|Copy Object|2
COPYRIGHT|Copyright|2
CPROBJ|Compress Object|2
CPY|Copy Object|2
CPYAUDJRNE|Copy Audit Journal Entries|2
CPYCFGL|Copy Configuration List|2
CPYDOC|Copy Document|2
CPYDSTRPSO|Copy Distribution Repository Object|2
CPYF|Copy File|2
CPYFCNARA|Copy Functional Area|2
CPYFRMARCF|Copy From Archive File|2
CPYFRMDIR|Copy From Directory|2
CPYFRMIMPF|Copy From Import File|2
CPYFRMLDIF|Copy From LDIF File|2
CPYFRMMSD|Copy From Main Storage Dump|2
CPYFRMPCD|Copy From PC Document|2
CPYFRMPCFF|Copy From Portable Compiled Format File|2
CPYFRMQRYF|Copy From Query File|2
CPYFRMSTMF|Copy From Stream File|2
CPYFRMTAP|Copy From Tape|2
CPYGPHFMT|Copy Graph Format|2
CPYGPHPKG|Copy Graph Package|2
CPYIGCSRT|Copy DBCS Master Sort Table|2
CPYIGCTBL|Copy DBCS Font Table|2
CPYJOBJS|Copy Job using Advanced Job Scheduler|2
CPYLIB|Copy Library|2
CPYMEDIBRM|Copy Media Information for BRMS|2
CPYOPT|Copy Optical|2
CPYPFRCOL|Copy Performance Collection|2
CPYPFRDTA|Copy Performance Data|2
CPYPTF|Copy Program Temporary Fix|2
CPYPTFCVR|Copy Program Temporary Fix Cover Letter|2
CPYPTFGRP|Copy Program Temporary Fix Group|2
CPYPTFSAVF|Copy Program Temporary Fix to Save File|2
CPYSPLF|Copy Spooled File|2
CPYSRCF|Copy Source File|2
CPYTCPHT|Copy TCP/IP Host Table|2
CPYTOARCF|Copy To Archive File|2
CPYTODIR|Copy To Directory|2
CPYTOIMPF|Copy To Import File|2
CPYTOLDIF|Copy To LDIF File|2
CPYTOMSD|Copy To Main Storage Dump|2
CPYTOPCD|Copy To PC Document|2
CPYTOPCFF|Copy To Portable Compiled Format File|2
CPYTOSTMF|Copy To Stream File|2
CPYTOTAP|Copy To Tape|2
CPYVPNCFGF|Copy VPN Configuration File|2
CRTAFPDTA|Create Advanced Function Printer Data|2
CRTALRTBL|Create Alert Table|2
CRTAUTHLR|Create Authority Holder|2
CRTAUTL|Create Authorization List|2
CRTBNDC|Create Bound C Program|2
CRTBNDCBL|Create Bound COBOL Program|2
CRTBNDCL|Create Bound CL Program|2
CRTBNDCPP|Create Bound C++ Program|2
CRTBNDDIR|Create Binding Directory|2
CRTBNDRPG|Create Bound RPG Program|2
CRTCAD|Create Cluster Administrative Domain|2
CRTCBLMOD|Create COBOL Module|2
CRTCBLPGM|Create COBOL Program|2
CRTCFGL|Create Configuration List|2
CRTCICSC|Create CICS ILE C Object|2
CRTCICSCBL|Create CICS COBOL Object|2
CRTCICSGRP|Create CICS Group|2
CRTCICSMAP|Create CICS Map|2
CRTCKMKSF|Create Crytographic Key Management Keystore File|2
CRTCLD|Create C Locale Description|2
CRTCLMOD|Create CL Module|2
CRTCLPGM|Create CL Program|2
CRTCLS|Create Class|2
CRTCLU|Create Cluster|2
CRTCMD|Create Command|2
CRTCMOD|Create C Module|2
CRTCOSD|Create Class-of-Service Description|2
CRTCPPMOD|Create C++ Module|2
CRTCRG|Create Cluster Resource Group|2
CRTCRQD|Create Change Request Description|2
CRTCSI|Create Communications Side Information|2
CRTCTLAPPC|Create Controller Description APPC|2
CRTCTLASC|Create Controller Description Async|2
CRTCTLBSC|Create Controller Description BSC|2
CRTCTLFNC|Create Controller Description Finance|2
CRTCTLHOST|Create Controller Description SNA Host|2
CRTCTLLWS|Create Controller Description Local WS|2
CRTCTLNET|Create Controller Description Network|2
CRTCTLRTL|Create Controller Description Retail|2
CRTCTLRWS|Create Controller Description Remote WS|2
CRTCTLTAP|Create Controller Description Tape|2
CRTCTLVWS|Create Controller Description Virtual WS|2
CRTDDMF|Create Distributed Data Management File|2
CRTDDNSCFG|Create Dynamic Domain Name System Configuration|2
CRTDEVAPPC|Create Device Description APPC|2
CRTDEVASC|Create Device Description Async|2
CRTDEVASP|Create Device Description ASP|2
CRTDEVBSC|Create Device Description BSC|2
CRTDEVCRP|Create Device Description Crypto|2
CRTDEVDSP|Create Device Description Display|2
CRTDEVFNC|Create Device Description Finance|2
CRTDEVHOST|Create Device Description SNA Host|2
CRTDEVINTR|Create Device Description Intra|2
CRTDEVMLB|Create Device Description Media Lib|2
CRTDEVNET|Create Device Description Network|2
CRTDEVNWSH|Create Device Description NWSH|2
CRTDEVOPT|Create Device Description Optical|2
CRTDEVPRT|Create Device Description Printer|2
CRTDEVRTL|Create Device Description Retail|2
CRTDEVSNPT|Create Device Description SNPT|2
CRTDEVSNUF|Create Device Description SNUF|2
CRTDEVTAP|Create Device Description Tape|2
CRTDFUDSPF|Create Data File Utility Display File|2
CRTDIR|Create Directory|2
CRTDOC|Create Document|2
CRTDPRTBL|Create DataPropagator Tables|2
CRTDSPF|Create Display File|2
CRTDSTL|Create Distribution List|2
CRTDTAARA|Create Data Area|2
CRTDTADCT|Create Data Dictionary|2
CRTDTAQ|Create Data Queue|2
CRTDUPOBJ|Create Duplicate Object|2
CRTEDTD|Create Edit Description|2
CRTFCNARA|Create Functional Area|2
CRTFCT|Create Forms Control Table|2
CRTFLR|Create Folder|2
CRTFMWPRD|Create Firmware Product|2
CRTFNTRSC|Create Font Resource|2
CRTFNTTBL|Create Font Table|2
CRTFORMDF|Create Form Definition|2
CRTFTR|Create Filter|2
CRTGDF|Create Graphics Data File|2
CRTGPHFMT|Create Graph Format|2
CRTGPHPKG|Create Graph Package|2
CRTGSS|Create Graphics Symbol Set|2
CRTHSTDTA|Create Historical Data|2
CRTICFF|Create Intersystem Communications Function File|2
CRTIGCDCT|Create DBCS Conversion Dictionary|2
CRTIMGCLG|Create Image Catalog|2
CRTINSTOND|Create Instance|2
CRTJOBD|Create Job Description|2
CRTJOBQ|Create Job Queue|2
CRTJRN|Create Journal|2
CRTJRNRCV|Create Journal Receiver|2
CRTLF|Create Logical File|2
CRTLIB|Create Library|2
CRTLINASC|Create Line Description Async|2
CRTLINBSC|Create Line Description BSC|2
CRTLINDDI|Create Line Description DDI|2
CRTLINETH|Create Line Description Ethernet|2
CRTLINFAX|Create Line Description Fax|2
CRTLINFR|Create Line Description Frame Relay|2
CRTLINPPP|Create Line Description PPP|2
CRTLINSDLC|Create Line Description SDLC|2
CRTLINTDLC|Create Line Description TDLC|2
CRTLINTRN|Create Line Description Token-Ring|2
CRTLINWLS|Create Line Description Wireless|2
CRTLINX25|Create Line Description X.25|2
CRTLOCALE|Create Locale|2
CRTMNU|Create Menu|2
CRTMODD|Create Mode Description|2
CRTMSGF|Create Message File|2
CRTMSGFMNU|Create Menu from Message Files|2
CRTMSGQ|Create Message Queue|2
CRTNODGRP|Create Node Group|2
CRTNODL|Create Node List|2
CRTNTBD|Create NetBIOS Description|2
CRTNWIFR|Create Network Interface Frame-Relay Network|2
CRTNWSCFG|Create Network Server Configuration|2
CRTNWSD|Create Network Server Description|2
CRTNWSSTG|Create Network Server Storage Space|2
CRTOUTQ|Create Output Queue|2
CRTOVL|Create Overlay|2
CRTPAGDFN|Create Page Definition|2
CRTPAGSEG|Create Page Segment|2
CRTPDFMAP|Create PDF Map|2
CRTPDG|Create Print Descriptor Group|2
CRTPEXDTA|Create Performance Explorer Data|2
CRTPF|Create Physical File|2
CRTPFRDTA|Create Performance Data|2
CRTPFRSUM|Create Performance Summary|2
CRTPGM|Create Program|2
CRTPNLGRP|Create Panel Group|2
CRTPRDDFN|Create Product Definition|2
CRTPRDLOD|Create Product Load|2
CRTPRTF|Create Printer File|2
CRTPRXCMD|Create Proxy Command|2
CRTPSFCFG|Create Print Services Facility Configuration|2
CRTPTF|Create Program Temporary Fix|2
CRTPTFPKG|Create Program Temporary Fix Package|2
CRTQMFORM|Create Query Management Form|2
CRTQMQRY|Create Query Management Query|2
CRTQSTDB|Create Question/Answer Database|2
CRTQSTLOD|Create Question/Answer Database Load|2
CRTRJEBSCF|Create RJE BSC File|2
CRTRJECFG|Create RJE Configuration|2
CRTRJECMNF|Create RJE Communication File|2
CRTRNDCCFG|Create Remote Name Daemon Control Configuration|2
CRTRPGMOD|Create RPG Module|2
CRTRPGPGM|Create RPG/400 Program|2
CRTRPTPGM|Create Auto Report RPG Program|2
CRTS36CBL|Create S/36 COBOL Program|2
CRTS36DSPF|Create S/36 Display File|2
CRTS36MNU|Create S/36 Menu|2
CRTS36MSGF|Create S/36 Message File|2
CRTS36RPG|Create RPG II Program|2
CRTS36RPGR|Create Console Display File|2
CRTS36RPT|Create S/36 RPG II Auto Report|2
CRTSAVF|Create Save File|2
CRTSBSD|Create Subsystem Description|2
CRTSCHIDX|Create Search Index|2
CRTSPADCT|Create Spelling Aid Dictionary|2
CRTSQLCBL|Create SQL COBOL Program|2
CRTSQLCBLI|Create SQL ILE COBOL Object|2
CRTSQLCI|Create SQL ILE C Object|2
CRTSQLCPPI|Create SQL ILE C++ Object|2
CRTSQLPKG|Create SQL Package|2
CRTSQLPLI|Create SQL PL/I Program|2
CRTSQLRPG|Create SQL RPG Program|2
CRTSQLRPGI|Create SQL ILE RPG Object|2
CRTSRCPF|Create Source Physical File|2
CRTSRVCFG|Create Service Configuration|2
CRTSRVPGM|Create Service Program|2
CRTSSND|Create Session Description|2
CRTTAPCGY|Create Tape Category|2
CRTTAPF|Create Tape File|2
CRTTBL|Create Table|2
CRTTIMZON|Create Time Zone Description|2
CRTUDFS|Create User-Defined File System|2
CRTUSRPRF|Create User Profile|2
CRTVLDL|Create Validation List|2
CRTWSCST|Create Workstation Customizing Object|2
CVTCLSRC|Convert CL Source|2
CVTDAT|Convert Date|2
CVTDIR|Convert Directory|2
CVTDLSNAM|Convert Document Library Services Name|2
CVTEDU|Convert Education|2
CVTIPSIFC|Convert IP Address|2
CVTIPSLOC|Convert Network ID / Location|2
CVTNAMSMTP|Convert SMTP Names|2
CVTOPTBKU|Convert Optical Backup|2
CVTOVLPFM|Convert Overlay to PFM|2
CVTPAGSPFM|Convert Page Segment to PFM|2
CVTPCDPAGS|Convert PC Document to Page Segment|2
CVTPFMPAGS|Convert Physical File Member to Page Segment|2
CVTPFRCOL|Convert Performance Collection|2
CVTPFRDTA|Convert Performance Data|2
CVTPFRTHD|Convert Performance Thread Data|2
CVTRJEDTA|Convert RJE Data|2
CVTRPCSRC|Convert Remote Procedure Call Source|2
CVTRPGSRC|Convert RPG Source|2
CVTTCPCL|Convert TCP/IP CL Source|2
CVTTOFLR|Convert To Folder|2
CVTUSRCERT|Convert User Certificate|2
DATA|Data|2
DB2LDIF|Copy To LDIF File|2
DCL|Declare CL Variable|2
DCLF|Declare File|2
DCLPRCOPT|Declare Processing Options|2
DCPOBJ|Decompress Object|2
DEL|Remove Link|2
DEP|Dependent Definition|2
DIG|Start DIG Query|2
DLCOBJ|Deallocate Object|2
DLTALR|Delete Alert|2
DLTALRTBL|Delete Alert Table|2
DLTAPARDTA|Delete APAR Data|2
DLTAUTCOL|Delete Authority Collection) |2
DLTAUTHLR|Delete Authority Holder|2
DLTAUTL|Delete Authorization List|2
DLTBNDDIR|Delete Binding Directory|2
DLTCAD|Delete Cluster Administrative Domain|2
DLTCFGL|Delete Configuration List|2
DLTCHTFMT|Delete Chart Format|2
DLTCICSGRP|Delete CICS Group|2
DLTCLD|Delete C Locale Description|2
DLTCLS|Delete Class|2
DLTCLU|Delete Cluster|2
DLTCMD|Delete Command|2
DLTCMNTRC|Delete Communications Trace|2
DLTCNNL|Delete Connection List|2
DLTCOSD|Delete Class-of-Service Description|2
DLTCRG|Delete Cluster Resource Group|2
DLTCRGCLU|Delete Cluster Resource Group Cluster|2
DLTCRQD|Delete Change Request Description|2
DLTCSI|Delete Communications Side Information|2
DLTCTLD|Delete Controller Description|2
DLTDEVD|Delete Device Description|2
DLTDEVMLB|Delete Device Media Library|2
DLTDFUPGM|Delete Data File Utility Program|2
DLTDLO|Delete Document Library Object|2
DLTDOCL|Delete Document List|2
DLTDST|Delete Distribution|2
DLTDSTL|Delete Distribution List|2
DLTDTAARA|Delete Data Area|2
DLTDTADCT|Delete Data Dictionary|2
DLTDTAQ|Delete Data Queue|2
DLTEDTD|Delete Edit Description|2
DLTEXPSPLF|Delete Expired Spooled Files|2
DLTF|Delete File|2
DLTFCNARA|Delete Functional Area|2
DLTFCT|Delete Forms Control Table|2
DLTFNTRSC|Delete Font Resource|2
DLTFNTTBL|Delete Font Table|2
DLTFORMDF|Delete Form Definition|2
DLTFTR|Delete Filter|2
DLTGPHFMT|Delete Graph Format|2
DLTGPHPKG|Delete Graph Package|2
DLTGSS|Delete Graphic Symbol Set|2
DLTHSTDTA|Delete Historical Data|2
DLTIGCDCT|Delete DBCS Conversion Dictionary|2
DLTIGCSRT|Delete DBCS Sort Table|2
DLTIGCTBL|Delete DBCS Font Table|2
DLTIMGCLG|Delete Image Catalog|2
DLTINTSVR|Delete Integrated Server|2
DLTIPXD|Delete IPX Description|2
DLTJOBD|Delete Job Description|2
DLTJOBQ|Delete Job Queue|2
DLTJRN|Delete Journal|2
DLTJRNRCV|Delete Journal Receiver|2
DLTKRBCCF|Delete Kerberos Credentials Cache File|2
DLTLIB|Delete library|2
DLTLICPGM|Delete Licensed Program|2
DLTLIND|Delete Line Description|2
DLTLNXSVR|Delete Linux Server|2
DLTLOCALE|Delete Locale|2
DLTMEDDFN|Delete Media Definition|2
DLTMGTCOL|Delete Management Collection|2
DLTMNU|Delete Menu|2
DLTMOD|Delete Module|2
DLTMODD|Delete Mode Description|2
DLTMSGF|Delete Message File|2
DLTMSGQ|Delete Message Queue|2
DLTNETF|Delete Network File|2
DLTNODGRP|Delete Node Group|2
DLTNODL|Delete Node List|2
DLTNTBD|Delete NetBIOS Descriptions|2
DLTNWID|Delete Network Interface Description|2
DLTNWSCFG|Delete Network Server Configuration|2
DLTNWSD|Delete Network Server Description|2
DLTNWSSTG|Delete Network Server Storage Space|2
DLTOBJ|Delete Object|2
DLTOUTQ|Delete Output Queue|2
DLTOVL|Delete Overlay|2
DLTOVR|Delete Override|2
DLTOVRDEVE|Delete Override Program Device Entry|2
DLTPAGDFN|Delete Page Definition|2
DLTPAGSEG|Delete Page Segment|2
DLTPDFMAP|Delete PDF Map|2
DLTPDG|Delete Print Descriptor Group|2
DLTPEXDTA|Delete Performance Explorer Data|2
DLTPFRCOL|Delete Performance Collection|2
DLTPFRDTA|Delete Performance Data|2
DLTPGM|Delete Program|2
DLTPNLGRP|Delete Panel Group|2
DLTPRB|Delete Problem|2
DLTPRDDFN|Delete Product Definition|2
DLTPRDLOD|Delete Product Load|2
DLTPSFCFG|Delete Print Services Facility Configuration|2
DLTPTF|Delete Program Temporary Fix|2
DLTQMFORM|Delete Query Management Form|2
DLTQMQRY|Delete Query Management Query|2
DLTQRY|Delete Query|2
DLTQST|Delete Questions and Answers|2
DLTQSTDB|Delete Question/Answer Database|2
DLTRJECFG|Delete RJE Configuration|2
DLTRMTPTF|Delete Remote Program Temporary Fix|2
DLTSBMCRQ|Delete Submitted Change Request|2
DLTSBSD|Delete Subsystem Description|2
DLTSCHIDX|Delete Search Index|2
DLTSMGOBJ|Delete System Manager Object|2
DLTSPADCT|Delete Spelling Aid Dictionary|2
DLTSPLF|Delete Spooled File|2
DLTSQLPKG|Delete SQL Package|2
DLTSRVCFG|Delete Service Configuration|2
DLTSRVPGM|Delete Service Program|2
DLTSSND|Delete Session Description|2
DLTTAPCGY|Delete Tape Category|2
DLTTBL|Delete Table|2
DLTTIMZON|Delete Time Zone Description|2
DLTTRC|Delete Trace|2
DLTUDFS|Delete User-Defined File System|2
DLTUSRIDX|Delete User Index|2
DLTUSRPRF|Delete User Profile|2
DLTUSRQ|Delete User Queue|2
DLTUSRSPC|Delete User Space|2
DLTUSRTRC|Delete User Trace|2
DLTVLDL|Delete Validation List|2
DLTWNTSVR|Delete Windows Server|2
DLTWSCST|Delete Workstation Customizing Object|2
DLYJOB|Delay Job|2
DLYSRVAGTP|Delay SRVAGT Problem Reporting|2
DMP|Dump Object|2
DMPBRM|Dump BRMS|2
DMPCICS|Dump CICS|2
DMPCLPGM|Dump CL Program|2
DMPCLUTRC|Dump Cluster Trace|2
DMPCMNTRC|Dump Communications Trace|2
DMPDLO|Dump Document Library Object|2
DMPDNSJRNF|Dump Domain Name System Journal File|2
DMPJOB|Dump Job|2
DMPJOBINT|Dump Job Internal|2
DMPMEMINF|Dump Main Memory Information|2
DMPOBJ|Dump Object|2
DMPSYSOBJ|Dump System Object|2
DMPTAP|Dump Tape|2
DMPTRC|Dump Trace|2
DMPUSRPRF|Dump User Profile|2
DMPUSRTRC|Dump User Trace|2
DO|Do Group|2
DOFOR|Do For|2
DOUNTIL|Do Until|2
DOWHILE|Do While|2
DSCJOB|Disconnect Job|2
DSPACC|Display Access Code|2
DSPACCAUT|Display Access Code Authority|2
DSPACTPJ|Display Active Prestart Jobs|2
DSPACTPRFL|Display Active Profile List|2
DSPACTSCD|Display Activation Schedule|2
DSPAPPNINF|Display APPN Information|2
DSPASPBRM|Display Auxiliary Storage Pool Information|2
DSPASPCPYD|Display ASP Copy Description|2
DSPASPSSN|Display ASP Session|2
DSPASPSTS|Display Auxiliary Storage Pool Status|2
DSPATR|Display Attributes) |2
DSPAUDJRNE|Display Audit Journal Entries|2
DSPAUT|Display Authority|2
DSPAUTHLR|Display Authority Holder|2
DSPAUTL|Display Authorization List|2
DSPAUTLDLO|Display Auth List Document Library Objects|2
DSPAUTLOBJ|Display Authorization List Object|2
DSPAUTUSR|Display Authorized Users|2
DSPBCKSTS|Display Backup Status|2
DSPBCKUP|Display Backup Options|2
DSPBCKUPL|Display Backup List|2
DSPBKP|Display Breakpoints|2
DSPBKUBRM|Display Backup Plan using BRMS|2
DSPBNDDIR|Display Binding Directory|2
DSPCCSA|Display Change Control Server Attributes|2
DSPCDEFNT|Display Coded Font|2
DSPCFGL|Display Configuration List|2
DSPCHT|Display Chart|2
DSPCICSCVT|Display CICS CVT Entry|2
DSPCICSDCT|Display CICS DCT Entry|2
DSPCICSFCT|Display CICS FCT Entry|2
DSPCICSGLT|Display CICS GLT Entry|2
DSPCICSJCT|Display CICS JCT Entry|2
DSPCICSPCT|Display CICS PCT Entry|2
DSPCICSPPT|Display CICS PPT Entry|2
DSPCICSSIT|Display CICS SIT Entry|2
DSPCICSSTS|Display CICS Status|2
DSPCICSTCS|Display CICS TCS Entry|2
DSPCICSTCT|Display CICS TCT Entry|2
DSPCICSTST|Display CICS TST Entry|2
DSPCKMKSFE|Display Crytographic Key Management Keystore File Entry|2
DSPCLS|Display Class|2
DSPCLUINF|Display Cluster Information|2
DSPCMD|Display Command|2
DSPCNNL|Display Connection List|2
DSPCNNSTS|Display Connection Status|2
DSPCOSD|Display Class-of-Service Description|2
DSPCPCST|Display Check Pending Constraint|2
DSPCRGINF|Display Cluster Resource Group Information|2
DSPCSI|Display Communications Side Information|2
DSPCTLD|Display Controller Description|2
DSPCURDIR|Display Current Directory|2
DSPDBG|Display Debug|2
DSPDBGWCH|Display Debug Watch|2
DSPDBR|Display Data Base Relations|2
DSPDDMF|Display Distributed Data Management File|2
DSPDEVD|Display Device Description|2
DSPDIRE|Display Directory Entries|2
DSPDLFA|Display DataLink File Attributes|2
DSPDLOAUD|Display Document Library Object Auditing Level|2
DSPDLOAUT|Display Document Library Object Authority|2
DSPDLONAM|Display Document Library Object Name|2
DSPDOC|Display Document|2
DSPDSTCLGE|Display Distribution Catalog Entries|2
DSPDSTL|Display Distribution List|2
DSPDSTLOG|Display Distribution Log|2
DSPDSTSRV|Display Distribution Services|2
DSPDTA|Display Data|2
DSPDTAARA|Display Data Area|2
DSPDTADCT|Display Data Dictionary|2
DSPDUPBRM|Display Duplicate Media|2
DSPEDTD|Display Edit Description|2
DSPEWCBCDE|Display Wireless Controller Barcode Entry|2
DSPEWCM|Display Wireless Controller Member|2
DSPEWCPTCE|Display Wireless Controller PTC Entry|2
DSPEWLM|Display Wireless Line Member|2
DSPEXPSCD|Display Expiration Schedule|2
DSPF|Display File|2
DSPFCNUSG|Display Function Usage|2
DSPFD|Display File Description|2
DSPFFD|Display File Field Description|2
DSPFLR|Display Folder|2
DSPFMWSTS|Display Firmware Status|2
DSPFNTRSCA|Display Font Resource Attributes|2
DSPFNTTBL|Display Font Table|2
DSPGDF|Display Graphics Data File|2
DSPHACFGD|Display HA Configuration Description) |2
DSPHDWRSC|Display Hardware Resources|2
DSPHFS|Display Hierarchical File Sys.|2
DSPHLPDOC|Display Help Document|2
DSPHSTGPH|Display Historical Graph|2
DSPHSTJS|Display History using Advanced Job Scheduler|2
DSPHYSSTGD|Display HyperSwap Storage Description|2
DSPHYSSTS|Display HyperSwap Status|2
DSPIGCDCT|Display DBCS Conversion Dictionary|2
DSPIPLA|Display IPL Attributes|2
DSPIPXD|Display IPX Description|2
DSPJOB|Display Job|2
DSPJOBD|Display Job Description|2
DSPJOBJS|Display Job using Advanced Job Scheduler|2
DSPJOBLOG|Display Job Log|2
DSPJOBTBL|Display Job Tables|2
DSPJRN|Display Journal|2
DSPJRNRCVA|Display Journal Receiver Attributes|2
DSPJVMJOB|Display Java Virtual Machine Jobs|2
DSPKBDMAP|Display Keyboard Map|2
DSPKRBCCF|Display Kerberos Credentials Cache File|2
DSPKRBKTE|Display Kerberos Keytab Entries|2
DSPLANADPP|Display LAN Adapter Profile|2
DSPLANMLB|Display LAN Media Library|2
DSPLANSTS|Display LAN Status|2
DSPLIB|Display Library|2
DSPLIBD|Display Library Description|2
DSPLIBL|Display Library List|2
DSPLICKEY|Display License Key Information|2
DSPLIND|Display Line Description|2
DSPLNK|Display Object Links|2
DSPLOG|Display Log|2
DSPLOGBRM|Display Log for BRMS|2
DSPLOGJS|Display Log for Job Scheduler|2
DSPMFSINF|Display Mounted File System Information|2
DSPMGDSYSA|Display Managed System Attributes|2
DSPMNUA|Display Menu Attributes|2
DSPMOD|Display Module|2
DSPMODD|Display Mode Description|2
DSPMODSRC|Display Module Source|2
DSPMODSTS|Display Mode Status|2
DSPMSG|Display Messages|2
DSPMSGD|Display Message Description|2
DSPNCK|Display Nickname|2
DSPNETA|Display Network Attributes|2
DSPNODGRP|Display Node Group|2
DSPNTBD|Display NetBIOS Description|2
DSPNWID|Display Network Interface Description|2
DSPNWSA|Display Network Server Attributes|2
DSPNWSCFG|Display Network Server Configuration|2
DSPNWSD|Display Network Server Description|2
DSPNWSSTG|Display Network Server Storage Space|2
DSPNWSUSRA|Display Network Server User Attributes|2
DSPOBJAUT|Display Object Authority|2
DSPOBJD|Display Object Description|2
DSPOPCLNK|Display OptiConnect Link Status|2
DSPOPT|Display Optical|2
DSPOPTLCK|Display Optical Locks|2
DSPOPTSVR|Display Optical Server|2
DSPOSPF|Display OSPF|2
DSPOVR|Display Override|2
DSPPDFMAPE|Display PDF Map Entries|2
DSPPDGPRF|Display Print Descriptor Group Profile|2
DSPPFM|Display Physical File Member|2
DSPPFRDTA|Display Performance Data|2
DSPPFRGPH|Display Performance Graph|2
DSPPGM|Display Program|2
DSPPGMADP|Display Program Adopt|2
DSPPGMREF|Display Program References|2
DSPPGMVAR|Display Program Variable|2
DSPPRB|Display Problems|2
DSPPSFCFG|Display Print Services Facility Configuration|2
DSPPTF|Display Program Temporary Fix|2
DSPPTFAPYI|Display PTF Apply Information|2
DSPPTFCVR|Display Program Temporary Fix Cover Letter|2
DSPPTFGRP|Display PTF Group) |2
DSPPWRSCD|Display Power On/Off Schedule|2
DSPRCDLCK|Display Record Locks|2
DSPRCVCMD|Display Received Commands|2
DSPRCYAP|Display Recovery for Access Paths|2
DSPRDBDIRE|Display Relational Database Directory Entries|2
DSPRIP|Display Routing Information Protocol Information|2
DSPRJECFG|Display RJE Configuration|2
DSPRMTDFN|Display Remote Definition|2
DSPS36|Display S/36 Configuration|2
DSPSAVF|Display Save File|2
DSPSBMCRQ|Display Submitted Change Requests|2
DSPSBMCRQA|Display Submitted Change Request Activity|2
DSPSBMCRQM|Display Submitted Change Request Messages|2
DSPSBSD|Display Subsystem Description|2
DSPSECA|Display Security Attributes|2
DSPSECAUD|Display Security Auditing|2
DSPSFWRSC|Display Software Resources|2
DSPSOCSTS|Display Sphere of Control Status|2
DSPSPLF|Display Spooled File|2
DSPSRVA|Display Service Attributes|2
DSPSRVAGT|Display Service Agent|2
DSPSRVPGM|Display Service Program|2
DSPSRVPVDA|Display Service Provider Attributes|2
DSPSRVSTS|Display Service Status|2
DSPSSTUSR|Display Service Tools User ID|2
DSPSVCCPYD|Display SAN Volume Controller ASP Copy Description|2
DSPSVCSSN|Display SAN Volume Controller ASP Session|2
DSPSVRAUTE|Display Server Authentication Entries|2
DSPSYSSTS|Display System Status|2
DSPSYSVAL|Display System Value|2
DSPTAP|Display Tape|2
DSPTAPCGY|Display Tape Category|2
DSPTAPCTG|Display Tape Cartridge|2
DSPTAPSTS|Display Tape Status|2
DSPTM|Display Trademarks|2
DSPTRC|Display Trace|2
DSPTRCDTA|Display Trace Data|2
DSPUDFS|Display User-Defined File System|2
DSPUSRPMN|Display User Permission|2
DSPUSRPRF|Display User Profile|2
DSPUSRPRTI|Display User Print Information|2
DSPVTMAP|Display VT Keyboard Map|2
DSPWLCGRP|Display Workload Group|2
DSPWSUSR|Display Work Station User|2
DUPMEDBRM|Duplicate Media using BRMS|2
DUPOPT|Duplicate Optical|2
DUPTAP|Duplicate Tape|2
EDTAUTL|Edit Authorization List|2
EDTBCKUPL|Edit Backup List|2
EDTCLU|Edit Control Language Utility|2
EDTCPCST|Edit Check Pending Constraints|2
EDTDLFA|Edit DataLink File Attributes|2
EDTDLOAUT|Edit Document Library Object Authority|2
EDTDOC|Edit Document|2
EDTF|Edit File|2
EDTIGCDCT|Edit DBCS Conversion Dictionary|2
EDTLIBL|Edit Library List|2
EDTOBJAUT|Edit Object Authority|2
EDTQST|Edit Questions and Answers|2
EDTRBDAP|Edit Rebuild of Access Paths|2
EDTRCYAP|Edit Recovery for Access Paths|2
EDTS36PGMA|Edit S/36 Program Attributes|2
EDTS36PRCA|Edit S/36 Procedure Attributes|2
EDTS36SRCA|Edit S/36 Source Attributes|2
EDTWSOAUT|Edit Workstation Object Authority|2
EJTEMLOUT|Eject Emulation Output|2
ELEM|Element Definition|2
ELSE|Else|2
EMLPRTKEY|Emulate Printer Keys|2
ENDACCWEB|End Access for Web|2
ENDACCWEB2|End Access for Web|2
ENDAGTSRV|End Agent Services|2
ENDASPBAL|End Auxiliary Storage Pool Balance|2
ENDASPSSN|End ASP Session|2
ENDAUTCOL|End Authority Collection) |2
ENDBCHJOB|End Batch Job|2
ENDCAD|End Cluster Administrative Domain|2
ENDCBLDBG|End COBOL Debug|2
ENDCHTSVR|End Clustered Hash Table Server|2
ENDCICS|End CICS Control Region|2
ENDCICSUSR|End CICS User Shell|2
ENDCLNUP|End Cleanup|2
ENDCLUNOD|End Cluster Node|2
ENDCMNSVR|End Communications Server|2
ENDCMNTRC|End Communications Trace|2
ENDCMTCTL|End Commitment Control|2
ENDCPYSCN|End Copy Screen|2
ENDCRG|End Cluster Resource Group|2
ENDCTLRCY|End Controller Recovery|2
ENDDBG|End Debug Mode|2
ENDDBGSVR|End Debug Server|2
ENDDBMON|End Database Monitor|2
ENDDEVRCY|End Device Recovery|2
ENDDIRSHD|End Directory Shadowing|2
ENDDO|End Do Group|2
ENDDPRAPY|End DataPropagator Apply|2
ENDDPRCAP|End DataPropagator Capture|2
ENDDSKRGZ|End Disk Reorganization|2
ENDDW|End Disk Watcher|2
ENDEPMENV|End EPM Environments|2
ENDFNTDWN|End Font Downloader|2
ENDGRPJOB|End Group Job|2
ENDHOSTSVR|End Host Server|2
ENDINP|End Input|2
ENDIPSIFC|End IP over SNA Interface|2
ENDISDB|End Interactive Source Debugger|2
ENDJOB|End Job|2
ENDJOBABN|End Job Abnormal|2
ENDJOBTRC|End Job Trace|2
ENDJRN|End Journal|2
ENDJRNAP|End Journal Access Path|2
ENDJRNLIB|End Journal Library|2
ENDJRNOBJ|End Journal Object|2
ENDJRNPF|End Journal Physical File|2
ENDJS|End Advanced Job Scheduler|2
ENDJW|End Job Watcher|2
ENDLINRCY|End Line Recovery|2
ENDLOGSVR|End Job Log Server|2
ENDMGDSYS|End Managed System Services|2
ENDMGRSRV|End Manager Services|2
ENDMOD|End Mode|2
ENDMONOND|End Monitor|2
ENDMSF|End Mail Server Framework|2
ENDNFSSVR|End Network File System Server|2
ENDNWIRCY|End Network Interface Recovery|2
ENDPASTHR|End Pass-Through|2
ENDPEX|End Performance Explorer|2
ENDPFRCOL|End Performance Collection|2
ENDPFRTRC|End Performance Trace|2
ENDPGM|End Program|2
ENDPGMEXP|End Program Export List|2
ENDPGMPRF|End Program Profiling|2
ENDPJ|End Prestart Jobs|2
ENDPRTEML|End Printer Emulation|2
ENDRCV|End Receive|2
ENDRDR|End Reader|2
ENDRJESSN|End RJE Session|2
ENDRMTSPT|End Remote Support|2
ENDRPCBIND|End Remote Procedure Call Binder Daemon|2
ENDRQS|End Request|2
ENDS36|End S/36 Session|2
ENDSAVSYNC|End Save Synchronization) |2
ENDSBMCRQA|End Submitted Change Request Activity|2
ENDSBS|End Subsystem|2
ENDSELECT|End Select|2
ENDSRVAGT|End Service Agent|2
ENDSRVJOB|End Service Job|2
ENDSUBR|End Subroutine|2
ENDSVCSSN|End SAN Volume Controller ASP Session|2
ENDSYS|End System|2
ENDSYSMGR|End System Manager|2
ENDTCP|End TCP/IP|2
ENDTCPABN|End TCP/IP Abnormal|2
ENDTCPCNN|End TCP/IP Connection|2
ENDTCPIFC|End TCP/IP Interface|2
ENDTCPPTP|End Point-to-Point TCP/IP|2
ENDTCPSVR|End TCP/IP Server|2
ENDTFMMGR|End Transform Manager|2
ENDTIESSN|End TIE Session|2
ENDTRC|End Trace|2
ENDTRPMGR|End Trap Manager|2
ENDVPNCNN|End VPN Connection|2
ENDWCH|End Watch|2
ENDWTR|End Writer|2
EOF|End of File|2
ERASE|Remove Link|2
EXPORT|Export a Program Symbol|2
EXPORTFS|Change Network File System Export|2
EXTMEDIBRM|Extract Media Information|2
EXTPGMINF|Extract Program Information|2
FILDOC|File Document|2
FMTDTA|Format Data|2
FNDKEYOND|Find Key|2
FNDSTRAMT|Find String using Application Management Toolset|2
FNDSTRAMT2|Find String with List using Application Management Toolset|2
FNDSTRPDM|Find String using Programming Development Manager|2
FNDSTRPDM2|Find String with List using Programming Development Manager|2
FTP|Start TCP/IP File Transfer|2
GENCAT|Generate Message Catalog|2
GENCKMKSFE|Generate Crytographic Key Management Keystore File Entry|2
GENCMDDOC|Generate Command Documentation|2
GENCSRC|Generate C/C++ Source|2
GENDNSDSRR|Generate Domain Name System Delgation Signer Resource Record|2
GENDNSKEY|Generate Domain Name System Key|2
GENJVMDMP|Generate Java Virtual Machine Dump|2
GENLICKEY|Generate License Key|2
GO|Go to Menu|2
GOTO|Go To|2
GRTACCAUT|Grant Access Code Authority|2
GRTDPRAUT|Grant DataPropagator Authority|2
GRTOBJAUT|Grant Object Authority|2
GRTUSRAUT|Grant User Authority|2
GRTUSRPMN|Grant User Permission|2
GRTWSOAUT|Grant Workstation Object Authority|2
HLDCMNDEV|Hold Communications Device|2
HLDDSTQ|Hold Distribution Queue|2
HLDJOB|Hold Job|2
HLDJOBJS|Hold Job using Advanced Job Scheduler|2
HLDJOBQ|Hold Job Queue|2
HLDJOBSCDE|Hold Job Schedule Entry|2
HLDOUTQ|Hold Output Queue|2
HLDPTF|Hold Program Temporary Fix|2
HLDRDR|Hold Reader|2
HLDSBMCRQA|Hold Submitted Change Request Activity|2
HLDSPLF|Hold Spooled File|2
HLDWTR|Hold Writer|2
HOST|Start HOST Query|2
IF|If|2
INCLUDE|Include CL Source|2
INSCICSGRP|Install CICS Group|2
INSINTSVR|Install Integrated Server|2
INSPTF|Install Program Temporary Fix|2
INSRMTPRD|Install Remote Product|2
INSWNTSVR|Install Windows Server|2
INZBRM|Initialize BRMS|2
INZCICS|Initialize CICS Tables|2
INZDLFM|Initialize DataLink File Manager|2
INZDPRCAP|Initialize DataPropagator Capture|2
INZDSTQ|Initialize Distribution Queue|2
INZMEDBRM|Initialize Media using BRMS|2
INZNWSCFG|Initialize Network Server Configuration|2
INZOPT|Initialize Optical|2
INZPCS|Initialize Client Access/400|2
INZPFM|Initialize Physical File Member|2
INZSYS|Initialize System|2
INZTAP|Initialize Tape|2
ITERATE|Iterate|2
JAVA|Run Java Program|2
LDIF2DB|Copy From LDIF File|2
LEAVE|Leave|2
LNKDTADFN|Link/Unlink Data Definition|2
LODIMGCLG|Load or Unload Image Catalog|2
LODIMGCLGE|Load/Unload/Mount Image Catalog Entry|2
LODIPFTR|Load/Unload IP Filter|2
LODOPTFMW|Load Optical Firmware|2
LODPTF|Load Program Temporary Fix|2
LODQSTDB|Load Question/Answer Database|2
LODRUN|Load and Run|2
LPR|Send TCP/IP Spooled File|2
MD|Create Directory|2
MGRBRM|Migrate using BRMS|2
MGRMEDRDAR|Migrate Media|2
MKDIR|Create Directory|2
MONMSG|Monitor Message|2
MONSWABRM|Monitor Save While Active|2
MOUNT|Add Mounted File System|2
MOV|Move Object|2
MOVDOC|Move Document|2
MOVE|Move Object|2
MOVMEDBRM|Move Media using BRMS|2
MOVOBJ|Move Object|2
MOVPFRCOL|Move Performance Collection) |2
MOVSPLFBRM|Move Spooled Files using BRMS|2
MRGFORMD|Merge Form Description|2
MRGMSGCLG|Merge Message Catalog|2
MRGMSGF|Merge Message File|2
MRGSPLFOND|Merge Spooled Files|2
MRGSRC|Merge Source|2
MRGTCPHT|Merge TCP/IP Host Table|2
NDPING|Send Neighbor Solicitation) |2
NETSTAT|Work with TCP/IP Network Status|2
NSLOOKUP|Start NSLOOKUP Query|2
NSUPDATE|Run Domain Name System Update|2
OPNDBF|Open Data Base File|2
OPNQRYF|Open Query File|2
ORDSPTPTF|Order Supported Product PTFs|2
OTHERWISE|Otherwise|2
OVRDBF|Override with Data Base File|2
OVRDSPF|Override with Display File|2
OVRICFDEVE|Override Intersystem Communications Function Program Device Entry|2
OVRICFF|Override Intersystem Communications Function File|2
OVRMSGF|Override Message File|2
OVRPRTF|Override with Printer File|2
OVRSAVF|Override with Save File|2
OVRTAPF|Override with Tape File|2
PARM|Parameter Definition|2
PGM|Program|2
PING|Verify TCP/IP Connection|2
PKGINSOBJ|Package Installable Object|2
PKGPRDDST|Package Product for Distribution|2
PKGPRDOPT|Package Product Option|2
PMTCTL|Prompt Control Definition|2
POSDBF|Position Data Base File|2
PRTACTRPT|Print Activity Report|2
PRTADPOBJ|Print Adopting Objects|2
PRTAFPDTA|Print Advanced Function Printer Data|2
PRTCADMRE|Print Cluster Administrative Domain Managed Resource Entry|2
PRTCICSTRC|Print CICS Trace|2
PRTCMDUSG|Print Command Usage|2
PRTCMNSEC|Print Communications Security|2
PRTCMNTRC|Print Communications Trace|2
PRTCPTRPT|Print Component Report|2
PRTDEVADR|Print Device Addresses|2
PRTDIRINF|Print Directory Information|2
PRTDOC|Print Document|2
PRTDOCOND|Print Document) |2
PRTDSKINF|Print Disk Information|2
PRTERRLOG|Print Error Log|2
PRTINTDTA|Print Internal Data|2
PRTIPSCFG|Print IP over SNA|2
PRTJOBDAUT|Print Job Description Authority|2
PRTJOBRPT|Print Job Interval Report|2
PRTJOBTRC|Print Job Trace|2
PRTJVMJOB|Print Java Virtual Machine Job|2
PRTLBLBRM|Print Labels using BRMS|2
PRTLCKRPT|Print Lock Report|2
PRTMEDBRM|Print Media Exceptions for BRMS|2
PRTMOVBRM|Print Media Movement|2
PRTOPCACT|Print OptiConnect Activity|2
PRTOPCJOB|Print OptiConnect Jobs|2
PRTPEXRPT|Print Performance Explorer Report|2
PRTPFDDTA|Print PFD Data|2
PRTPOLRPT|Print Pool Report|2
PRTPRFINT|Print Profile Internals|2
PRTPUBAUT|Print Publicly Authorized Objects|2
PRTPVTAUT|Print Private Authorities|2
PRTQAUT|Print Queue Authority|2
PRTRPTBRM|Print Report for BRMS|2
PRTRPTOND|Print Report|2
PRTRSCRPT|Print Resource Report|2
PRTSBSDAUT|Print Subsystem Description|2
PRTSCDJS|Print Schedule using Advanced Job Scheduler|2
PRTSQLINF|Print SQL Information|2
PRTSWL|Print Stop Word List|2
PRTSYSINF|Print System Information|2
PRTSYSRPT|Print System Report|2
PRTSYSSECA|Print System Security Attributes) comman|2
PRTTCPPTP|Print TCP/IP Point-to-Point Profile|2
PRTTNSRPT|Print Transaction Report|2
PRTTRC|Print Trace Data|2
PRTTRCRPT|Print Job Trace Report|2
PRTTRGPGM|Print Trigger Programs|2
PRTTXTOND|Print Text|2
PRTUSROBJ|Print User Objects|2
PRTUSRPRF|Print User Profile|2
PWRDWNSYS|Power Down System|2
QRYDOCLIB|Query Document Library|2
QRYDOCOND|Query Document) |2
QRYDST|Query Distributions|2
QRYPRBSTS|Query Problem Status|2
QRYTIEF|Query TIE Files|2
QSH|Start QSH|2
QUAL|Qualifier Definition|2
RCLACTGRP|Reclaim Activation Group|2
RCLAPPN|Reclaim APPN|2
RCLDBXREF|Reclaim Database Cross-Reference|2
RCLDDMCNV|Reclaim Distributed Data Management Conversations|2
RCLDLO|Reclaim Document Library Object|2
RCLLIB|Reclaim Library|2
RCLLNK|Reclaim Object Links|2
RCLOBJOWN|Reclaim Objects by Owner|2
RCLOPT|Reclaim Optical|2
RCLRSC|Reclaim Resources|2
RCLSPLSTG|Reclaim Spool Storage|2
RCLSTG|Reclaim Storage|2
RCLTMPSTG|Reclaim Temporary Storage|2
RCVDST|Receive Distribution|2
RCVF|Receive File|2
RCVJRNE|Receive Journal Entry|2
RCVMSG|Receive Message|2
RCVNETF|Receive Network File|2
RCVTIEF|Receive TIE File|2
RD|Remove Directory|2
READFILE|Read a File|2
REN|Rename Object|2
RETURN|Return|2
RGZDLO|Reorganize Document Library Object|2
RGZPFM|Reorganize Physical File Member|2
RLSCMNDEV|Release Communications Device|2
RLSDSTQ|Release Distribution Queue|2
RLSIFSLCK|Release File System Locks|2
RLSJOB|Release Job|2
RLSJOBJS|Release Job using Advanced Job Scheduler|2
RLSJOBQ|Release Job Queue|2
RLSJOBSCDE|Release Job Schedule Entry|2
RLSOUTQ|Release Output Queue|2
RLSPTF|Release Program Temporary Fix|2
RLSRDR|Release Reader|2
RLSRMTPHS|Release Remote Phase|2
RLSSBMCRQA|Release Submitted Change Request Activity|2
RLSSPLF|Release Spooled File|2
RLSWTR|Release Writer|2
RMDIR|Remove Directory|2
RMVACC|Remove Access Code|2
RMVACCWEB|Remove Access for Web|2
RMVACCWEB2|Remove Access for Web|2
RMVAJE|Remove Autostart Job Entry|2
RMVALRD|Remove Alert Description|2
RMVASPCPYD|Remove ASP Copy Description|2
RMVAUTLE|Remove Authorization List Entry|2
RMVBKP|Remove Breakpoint|2
RMVBNDDIRE|Remove Binding Directory Entry|2
RMVCADMRE|Remove Cluster Administrative Domain Managed Resource Entry|2
RMVCADNODE|Remove Cluster Administrative Domain Node Entry|2
RMVCCSCLT|Remove Change Control Server Client|2
RMVCFGLE|Remove Configuration List Entries|2
RMVCICSCVT|Remove CICS CVT Entry|2
RMVCICSDCT|Remove CICS DCT Entry|2
RMVCICSFCT|Remove CICS FCT Entry|2
RMVCICSGLT|Remove CICS GLT Entry|2
RMVCICSJCT|Remove CICS JCT Entry|2
RMVCICSPCT|Remove CICS PCT Entry|2
RMVCICSPPT|Remove CICS PPT Entry|2
RMVCICSSIT|Remove CICS SIT Entry|2
RMVCICSTCS|Remove CICS TCS Entry|2
RMVCICSTCT|Remove CICS TCT Entry|2
RMVCICSTST|Remove CICS TST Entry|2
RMVCKMKSFE|Remove Crytographic Key Management Keystore File Entry|2
RMVCLUMON|Remove Cluster Monitor|2
RMVCLUNODE|Remove Cluster Node Entry|2
RMVCMNE|Remove Communications Entry|2
RMVCOMSNMP|Remove Community for SNMP|2
RMVCRGDEVE|Remove Cluster Resource Group Device Entry|2
RMVCRGNODE|Remove Cluster Resource Group Node Entry|2
RMVCRQDA|Remove Change RequestD Activity|2
RMVDEVDMNE|Remove Device Domain Entry|2
RMVDFRID|Remove Defer Identifier|2
RMVDIR|Remove Directory|2
RMVDIRE|Remove Directory Entry|2
RMVDIRINST|Remove Directory Server Instance|2
RMVDIRSHD|Remove Directory Shadow System|2
RMVDLOAUT|Remove Document Library Object Authority|2
RMVDPRREG|Remove DataPropagator Registration|2
RMVDPRSUB|Remove DataPropagator Subscription|2
RMVDPRSUBM|Remove DataPropagator Subscription Member|2
RMVDSTCLGE|Remove Distribution Catalog Entry|2
RMVDSTLE|Remove Distribution List Entry|2
RMVDSTQ|Remove Distribution Queue|2
RMVDSTRTE|Remove Distribution Route|2
RMVDSTSYSN|Remove Secondary System Name|2
RMVDWDFN|Remove Disk Watcher Definition|2
RMVEMLCFGE|Remove Configuration Entry|2
RMVENVVAR|Remove Environment Variable|2
RMVEWCBCDE|Remove Wireless Controller Barcode Entry|2
RMVEWCPTCE|Remove Wireless Controller PTC Entry|2
RMVEXITPGM|Remove Exit Program|2
RMVFCTE|Remove Forms Control Entry|2
RMVFNTTBLE|Remove Font Table Entry|2
RMVFTRACNE|Remove Filter Action Entry|2
RMVFTRSLTE|Remove Filter Selection Entry|2
RMVHACFGD|Remove HA Configuration Description) |2
RMVHSTJS|Remove History using Advanced Job Scheduler|2
RMVHYSSTGD|Remove HyperSwap Storage Description|2
RMVICFDEVE|Remove Intersystem Communications Function Device Entry|2
RMVIMGCLGE|Remove Image Catalog Entry|2
RMVIPSIFC|Remove IP over SNA Interface|2
RMVIPSLOC|Remove IP over SNA Location|2
RMVIPSRTE|Remove IP over SNA Route|2
RMVJOBJS|Remove Job using Advanced Job Scheduler|2
RMVJOBQE|Remove Job Queue Entry|2
RMVJOBSCDE|Remove Job Schedule Entry|2
RMVJRNCHG|Remove Journaled Changes|2
RMVJWDFN|Remove Job Watcher Definition|2
RMVKRBKTE|Remove Kerberos Keytab Entry|2
RMVLANADPI|Remove LAN Adapter Information|2
RMVLANADPT|Remove LAN Adapter|2
RMVLIBLE|Remove Library List Entry|2
RMVLICKEY|Remove License Key Information|2
RMVLNK|Remove Link|2
RMVLOGEBRM|Remove Log Entries from BRMS|2
RMVLOGEJS|Remove Log Entries from Job Scheduler|2
RMVM|Remove Member|2
RMVMEDBRM|Remove Media Volumes from BRMS|2
RMVMEDIBRM|Remove Media Information from BRMS|2
RMVMFS|Remove Mounted File System|2
RMVMSG|Remove Message|2
RMVMSGD|Remove Message Description|2
RMVNCK|Remove Nickname|2
RMVNETJOBE|Remove Network Job Entry|2
RMVNETTBLE|Remove Network Table Entry|2
RMVNODLE|Remove Node List Entry|2
RMVNWSSTGL|Remove Server Storage Link|2
RMVOPTCTG|Remove Optical Cartridge|2
RMVOPTSVR|Remove Optical Server|2
RMVOSPFARA|Remove OSPF Area|2
RMVOSPFIFC|Remove OSPF Interface|2
RMVOSPFLNK|Remove OSPF Virtual Link|2
RMVOSPFRNG|Remove OSPF Range|2
RMVPCLTBLE|Remove Protocol Table Entry|2
RMVPEXDFN|Remove Performance Explorer Definition|2
RMVPEXFTR|Remove Performance Explorer Filter|2
RMVPFCST|Remove Physical File Constraint|2
RMVPFTRG|Remove Physical File Trigger|2
RMVPGM|Remove Program|2
RMVPJE|Remove Prestart Job Entry|2
RMVPTF|Remove Program Temporary Fix|2
RMVRDBDIRE|Remove Relational Database Directory Entry|2
RMVREXBUF|Remove REXX Buffer|2
RMVRIPACP|Remove Routing Information Protocol Accepted Route|2
RMVRIPFLT|Remove Routing Information Protocol Filter|2
RMVRIPIFC|Remove Routing Information Protocol Interface|2
RMVRIPIGN|Remove Ignored Routing Information Protocol Neighbor|2
RMVRJECMNE|Remove RJE Communication Entry|2
RMVRJERDRE|Remove RJE Reader Entry|2
RMVRJEWTRE|Remove RJE Writer Entry|2
RMVRMTDFN|Remove Remote Definition|2
RMVRMTJRN|Remove Remote Journal|2
RMVRMTPTF|Remove Remote Program Temporary Fix|2
RMVRPTOND|Remove Report|2
RMVRPYLE|Remove Reply List Entry|2
RMVRTGE|Remove Routing Entry|2
RMVSCHIDXE|Remove Search Index Entry|2
RMVSMTPLE|Remove SMTP List Entry|2
RMVSOCE|Remove Sphere of Control Entry|2
RMVSRVTBLE|Remove Service Table Entry|2
RMVSVCCPYD|Remove SAN Volume Controller ASP Copy Description|2
RMVSVRAUTE|Remove Server Authentication Entry|2
RMVTAPCTG|Remove Tape Cartridge|2
RMVTCPHTE|Remove TCP/IP Host Table Entry|2
RMVTCPIFC|Remove TCP/IP Interface|2
RMVTCPPORT|Remove TCP/IP Port Restriction|2
RMVTCPPTP|Remove TCP/IP Point-to-Point Profile|2
RMVTCPRSI|Remove TCP/IP Remote System|2
RMVTCPRTE|Remove TCP/IP Route|2
RMVTCPSVR|Remove TCP/IP Server|2
RMVTCPTBL|Remove TCP/IP Table|2
RMVTRC|Remove Trace|2
RMVTRCFTR|Remove Trace Filter|2
RMVUSRSMTP|Remove User SMTP|2
RMVUSRSNMP|Remove User for SNMP|2
RMVWLCGRP|Remove Workload Group|2
RMVWLCPRDE|Remove Workload Product Entry|2
RMVWSE|Remove Work Station Entry|2
RNDC|Run Remote Name Daemon Control Command|2
RNM|Rename Object|2
RNMDIRE|Rename Directory Entry|2
RNMDLO|Rename Document Library Object|2
RNMDSTL|Rename Distribution List|2
RNMJOBJS|Rename Job using Advanced Job Scheduler|2
RNMLANADPI|Rename LAN Adapter|2
RNMM|Rename Member|2
RNMNCK|Rename Nickname|2
RNMOBJ|Rename Object|2
RNMTCPHTE|Rename TCP/IP Host Table Entry|2
ROLLBACK|Rollback|2
RPCBIND|Start Remote Procedure Call Binder Daemon|2
RPCGEN|Convert Remote Procedure Call Source|2
RPLDOC|Replace Document|2
RRTJOB|Reroute Job|2
RSMBKP|Resume Breakpoint|2
RSMCTLRCY|Resume Controller Recovery|2
RSMDEVRCY|Resume Device Recovery|2
RSMLINRCY|Resume Line Recovery|2
RSMNWIRCY|Resume Network Interface Recovery|2
RSMRTVBRM|Resume Retrieve using BRMS|2
RST|Restore Object|2
RSTAPARDTA|Restore APAR Data|2
RSTAUT|Restore Authority|2
RSTAUTBRM|Restore Authority using BRMS|2
RSTBRM|Restore Object using BRMS|2
RSTCFG|Restore Configuration|2
RSTDFROBJ|Restore Deferred Objects|2
RSTDLO|Restore Document Library Object|2
RSTDLOBRM|Restore Document Library Object using BRMS|2
RSTLIB|Restore Library|2
RSTLIBBRM|Restore Library using BRMS|2
RSTLICPGM|Restore Licensed Program|2
RSTOBJ|Restore Object|2
RSTOBJBRM|Restore Object using BRMS|2
RSTPFRCOL|Restore Performance Collection|2
RSTS36F|Restore S/36 File|2
RSTS36LIBM|Restore S/36 Library Members|2
RSTSYSINF|Restore System Information|2
RSTUSRPRF|Restore User Profiles|2
RTNSUBR|Return from Subroutine|2
RTVASPCPYD|Retrieve ASP Copy Description|2
RTVASPSSN|Retrieve ASP Session|2
RTVAUTLE|Retrieve Authorization List Entry|2
RTVBCKUP|Retrieve Backup Options|2
RTVBNDSRC|Retrieve Binder Source|2
RTVCFGSRC|Retrieve Configuration Source|2
RTVCFGSTS|Retrieve Configuration Status|2
RTVCLDSRC|Retrieve C Locale Description|2
RTVCLNUP|Retrieve Cleanup|2
RTVCLSRC|Retrieve CL Source|2
RTVCLU|Retrieve Cluster|2
RTVCRG|Retrieve Cluster Resource Group|2
RTVCURDIR|Retrieve Current Directory|2
RTVDIRINF|Retrieve Directory Information|2
RTVDLOAUT|Retrieve Document Library Object Authority|2
RTVDLONAM|Retrieve Document Library Object Name|2
RTVDOC|Retrieve Document|2
RTVDOCOND|Retrieve Document) |2
RTVDSKINF|Retrieve Disk Information|2
RTVDTAARA|Retrieve Data Area|2
RTVGRPA|Retrieve Group Attributes|2
RTVIMGCLG|Retrieve Image Catalog|2
RTVJOBA|Retrieve Job Attributes|2
RTVJRNE|Retrieve Journal Entry|2
RTVLIBD|Retrieve Library Description|2
RTVMBRD|Retrieve Member Description|2
RTVMSG|Retrieve Message|2
RTVNETA|Retrieve Network Attributes|2
RTVOBJD|Retrieve Object Description|2
RTVPDGPRF|Retrieve Print Descriptor Group Profile|2
RTVPRD|Retrieve Product|2
RTVPTF|Retrieve Program Temporary Fix|2
RTVPWRSCDE|Retrieve Power Schedule Entry|2
RTVQMFORM|Retrieve Query Management Form|2
RTVQMQRY|Retrieve Query Mgmt Query|2
RTVS36A|Retrieve S/36 Environment Attributes|2
RTVSMGOBJ|Retrieve System Manager Object|2
RTVSRVAGT|Retrieve Service Agent|2
RTVSVCCPYD|Retrieve SVC Copy Description|2
RTVSVCSSN|Retrieve SVC Session|2
RTVSWLSRC|Retrieve Stop Word List Source|2
RTVSYSINF|Retrieve System Information|2
RTVSYSVAL|Retrieve System Value|2
RTVTBLSRC|Retrieve Table Source|2
RTVTCPINF|Retrieve TCP/IP Information|2
RTVUSRPRF|Retrieve User Profile|2
RTVUSRPRTI|Retrieve User Print Information|2
RTVWSCST|Retrieve Workstation Customizing Object Source|2
RUNBCKUP|Run Backup|2
RUNDNSUPD|Run Domain Name System Update|2
RUNJVA|Run Java Program|2
RUNLPDA|Run LPDA-2|2
RUNQRY|Run Query|2
RUNRMTCMD|Run Remote Command|2
RUNRNDCCMD|Run Remote Name Daemon Control Command|2
RUNSMGCMD|Run System Manager Command|2
RUNSMGOBJ|Run System Manager Object|2
RUNSQL|Run SQL|2
RUNSQLSTM|Run SQL Statement|2
RVKACCAUT|Revoke Access Code Authority|2
RVKDPRAUT|Revoke DataPropagator Authority|2
RVKOBJAUT|Revoke Object Authority|2
RVKPUBAUT|Revoke Public Authority|2
RVKUSRPMN|Revoke User Permission|2
RVKWSOAUT|Revoke Workstation Object Authority|2
SAV|Save Object|2
SAVAPARDTA|Save APAR Data|2
SAVBRM|Save Object using BRMS|2
SAVCFG|Save Configuration|2
SAVCHGOBJ|Save Changed Objects|2
SAVCICSGRP|Save CICS Group|2
SAVDLO|Save Document Library Object|2
SAVDLOBRM|Save Document Library Object using BRMS|2
SAVFLRLBRM|Save Folder List using BRMS|2
SAVLIB|Save Library|2
SAVLIBBRM|Save Library using BRMS|2
SAVLICPGM|Save Licensed Program|2
SAVMEDIBRM|Save Media Information using BRMS|2
SAVOBJ|Save Object|2
SAVOBJBRM|Save Object using BRMS|2
SAVOBJLBRM|Save Object List using BRMS|2
SAVPFRCOL|Save Performance Collection|2
SAVRST|Save Restore|2
SAVRSTCFG|Save Restore Configuration|2
SAVRSTCHG|Save Restore Changed Objects|2
SAVRSTDLO|Save Restore Document Library Object|2
SAVRSTLIB|Save Restore Library|2
SAVRSTOBJ|Save Restore Object|2
SAVS36F|Save S/36 File|2
SAVS36LIBM|Save S/36 Library Members|2
SAVSAVFBRM|Save Save Files using BRMS|2
SAVSAVFDTA|Save Save File Data|2
SAVSECDTA|Save Security Data|2
SAVSYS|Save System|2
SAVSYSBRM|Save System using BRMS|2
SAVSYSINF|Save System Information|2
SBMCMDJS|Submit Console Command|2
SBMCODEJOB|Submit CODE Batch Job|2
SBMCRQ|Submit Change Request|2
SBMDBJOB|Submit Data Base Jobs|2
SBMFNCJOB|Submit Finance Job|2
SBMJOB|Submit Job|2
SBMJOBJS|Submit Job using Advanced Job Scheduler|2
SBMNETJOB|Submit Network Job|2
SBMNWSCMD|Submit Network Server Command|2
SBMRJEJOB|Submit RJE Job|2
SBMRMTCMD|Submit Remote Command|2
SELECT|Select|2
SETASPGRP|Set Auxiliary Storage Pool Group|2
SETATNPGM|Set Attention Program|2
SETCSTDTA|Set Customization Data|2
SETDEPJS|Set Dependent Job using Advanced Job Scheduler|2
SETDLJS|Set Data Library using Advanced Job Scheduler|2
SETDNSRVK|Set DNSSEC REVOKE Bit|2
SETKBDMAP|Set Keyboard Map|2
SETMEDBRM|Set Media Controls using BRMS|2
SETMSTKEY|Set Master Key|2
SETOBJACC|Set Object Access|2
SETPGMINF|Set Program Information|2
SETRTVBRM|Set Retrieve Controls for BRMS|2
SETSTPJS|Set Step using Advanced Job Scheduler|2
SETTAPCGY|Set Tape Category|2
SETUPGENV|Set Upgrade Environment|2
SETUSRBRM|Set User Usage for BRMS|2
SETVTMAP|Set VT Keyboard Map|2
SETVTTBL|Set VT Mapping Tables|2
SIGNOFF|Sign Off|2
SLTCMD|Select Command|2
SNDARPRQS|Send Address Resolution Protocol Request|2
SNDBRKMSG|Send Break Message|2
SNDDST|Send Distribution|2
SNDDSTJS|Send Distribution using Advanced Job Scheduler|2
SNDDSTQ|Send Distribution Queue|2
SNDF|Send File|2
SNDJRNE|Send Journal Entry|2
SNDLIC|Send License|2
SNDMSG|Send Message|2
SNDNETF|Send Network File|2
SNDNETMSG|Send Network Message|2
SNDNETSPLF|Send Network Spooled File|2
SNDNGHSOL|Send Neighbor Solicitation) |2
SNDPGMMSG|Send Program Message|2
SNDPRD|Send Product|2
SNDPTF|Send Program Temporary Fix|2
SNDPTFORD|Send Program Temporary Fix Order|2
SNDRCVF|Send/Receive File|2
SNDRJECMD|Send RJE Command|2
SNDRPTJS|Send Reports using Advanced Job Scheduler|2
SNDRPY|Send Reply|2
SNDSMGOBJ|Send System Manager Object|2
SNDSMTPEMM|Send SMTP E-mail Message|2
SNDSRVRQS|Send Service Request|2
SNDTCPSPLF|Send TCP/IP Spooled File|2
SNDTIEF|Send TIE File|2
SNDUSRMSG|Send User Message|2
STATFS|Display Mounted File System Information|2
STRACCWEB|Start Access for Web|2
STRACCWEB2|Start Access for Web|2
STRAFPU|Start Advanced Function Printer Utilities|2
STRAGTSRV|Start Agent Services|2
STRAMT|Start Application Management Toolset|2
STRAPF|Advanced Printer Function|2
STRARCBRM|Start Archive using BRMS|2
STRASMOND|Start Archived Storage Management|2
STRASPBAL|Start Auxiliary Storage Pool Balance|2
STRASPSSN|Start ASP Session|2
STRAUTCOL|Start Authority Collection) |2
STRBALBRM|Start Media Balancing for BRMS|2
STRBGU|Start Business Graphics Utility|2
STRBKUBRM|Start Backup using BRMS|2
STRCAD|Start Cluster Administrative Domain|2
STRCBLDBG|Start COBOL Debug|2
STRCGU|Start Character Generator Utility|2
STRCHTSVR|Start Clustered Hash Table Server|2
STRCICS|Start CICS Control Region|2
STRCICSUSR|Start CICS User Shell|2
STRCLNUP|Start Cleanup|2
STRCLUNOD|Start Cluster Node|2
STRCMNSVR|Start Communications Server|2
STRCMNTRC|Start Communications Trace|2
STRCMTCTL|Start Commitment Control|2
STRCODE|Start CODE|2
STRCODECMD|Start CODE Command|2
STRCPYSCN|Start Copy Screen|2
STRCRG|Start Cluster Resource Group|2
STRDBG|Start Debug|2
STRDBGSVR|Start Debug Server|2
STRDBMON|Start Database Monitor|2
STRDBRDR|Start Data Base Reader|2
STRDFU|Start Data File Utility|2
STRDIGQRY|Start DIG Query|2
STRDIRSHD|Start Directory Shadowing|2
STRDNSQRY|Start NSLOOKUP Query|2
STRDPRAPY|Start DataPropagator Apply|2
STRDPRCAP|Start DataPropagator Capture|2
STRDSKRGZ|Start Disk Reorganization|2
STRDSMOND|Start Disk Storage Management|2
STRDW|Start Disk Watcher|2
STREDU|Start Education|2
STREML3270|Start 3270 Display Emulation|2
STREPMENV|Start EPM Environment|2
STREXPBRM|Start Expiration for BRMS|2
STRFMA|Start Font Management Aid|2
STRFNTDWN|Start Font Downloader|2
STRGRPJS|Start Group using Advanced Job Scheduler|2
STRHOSTQRY|Start HOST Query|2
STRHOSTSVR|Start Host Server|2
STRIDD|Start IDDU|2
STRIMPOND|Start Import|2
STRIMPSMTP|Start Import for SMTP Users|2
STRIPSIFC|Start IP over SNA Interface|2
STRISDB|Start Interactive Source Debugger|2
STRITF|Start Interactive Terminal Facility|2
STRJOBTRC|Start Job Trace|2
STRJRN|Start Journal|2
STRJRNAP|Start Journal Access Path|2
STRJRNLIB|Start Journal Library|2
STRJRNOBJ|Start Journal Object|2
STRJRNPF|Start Journal Physical File|2
STRJS|Start Advanced Job Scheduler|2
STRJW|Start Job Watcher|2
STRLOGSVR|Start Job Log Server|2
STRMGDSYS|Start Managed System Services|2
STRMGRBRM|Start Migration using BRMS|2
STRMGRSRV|Start Manager Services|2
STRMNTBRM|Start Maintenance for BRMS|2
STRMOD|Start Mode|2
STRMONOND|Start Monitor|2
STRMSF|Start Mail Server Framework|2
STRNETINS|Start Network Install|2
STRNFSSVR|Start Network File System Server|2
STROBJCVN|Start Object Conversion|2
STROVLU|Start Overlay Utility|2
STRPASTHR|Start Pass-Through|2
STRPCCMD|Start PC Command|2
STRPCO|Start PC Organizer|2
STRPDM|Start Programming Development Manager|2
STRPEX|Start Performance Explorer|2
STRPFRCOL|Start Performance Collection|2
STRPFRG|Start Performance Graphics|2
STRPFRT|Start Performance Tools|2
STRPFRTRC|Start Performance Trace|2
STRPFU|Start Print Format Utility|2
STRPGMEXP|Start Program Export List|2
STRPGMMNU|Start Programmer Menu|2
STRPGMPRF|Start Program Profiling|2
STRPJ|Start Prestart Jobs|2
STRPRTEML|Start Printer Emulation|2
STRPRTWTR|Start Printer Writer|2
STRQM|Start DB2 UDB Query Manager|2
STRQMPRC|Start Query Management Proc|2
STRQMQRY|Start Query Management Query|2
STRQRY|Start Query|2
STRQSH|Start QSH|2
STRQST|Start Question and Answer|2
STRRCYBRM|Start Recovery using BRMS|2
STRREXPRC|Start REXX Procedure|2
STRRJECSL|Start RJE Console|2
STRRJERDR|Start RJE Reader|2
STRRJESSN|Start RJE Session|2
STRRJEWTR|Start RJE Writer|2
STRRLU|Start Report Layout Utility|2
STRRMCRDAR|Start Report Management Cycle|2
STRRMTSPT|Start Remote Support|2
STRRMTWTR|Start Remote Writer|2
STRRSESVR|Start Remote Systems Explorer Server|2
STRS36|Start S/36 Session|2
STRS36PRC|Start S/36 Procedure|2
STRSAVSYNC|Start Save Synchronization|2
STRSBS|Start Subsystem|2
STRSBSBRM|Start Subsystems using BRMS|2
STRSCHIDX|Start Search Index|2
STRSDA|Start Screen Design Aid|2
STRSEU|Start Source Entry Utility|2
STRSPLRCL|Start Spool Reclaim|2
STRSPTN|Start Support Network|2
STRSQL|Start SQL Interactive Session|2
STRSRVAGT|Start Service Agent|2
STRSRVJOB|Start Service Job|2
STRSST|Start System Service Tools|2
STRSVCSSN|Start SAN Volume Controller ASP Session|2
STRSYSMGR|Start System Manager|2
STRTCP|Start TCP/IP|2
STRTCPFTP|Start TCP/IP File Transfer|2
STRTCPIFC|Start TCP/IP Interface|2
STRTCPPTP|Start TCP/IP Point-to-Point|2
STRTCPSVR|Start TCP/IP Server|2
STRTCPTELN|Start TCP/IP TELNET|2
STRTFMMGR|Start Transform Manager|2
STRTIESSN|Start TIE Session|2
STRTRC|Start Trace|2
STRTRPMGR|Start Trap Manager|2
STRVPNCNN|Start VPN Connection|2
STRWCH|Start Watch|2
SUBR|Subroutine|2
TELNET|Start TCP/IP TELNET|2
TFRBCHJOB|Transfer Batch Job|2
TFRCTL|Transfer Control|2
TFRGRPJOB|Transfer to Group Job|2
TFRJOB|Transfer Job|2
TFRPASTHR|Transfer Pass-Through|2
TFRSECJOB|Transfer Secondary Job|2
TRACEROUTE|Trace Route of an IP Packet|2
TRCASPBAL|Trace Auxiliary Storage Pool Balance|2
TRCCNN|Trace Connection|2
TRCCPIC|Trace CPI Communications|2
TRCICF|Trace Intersystem Communications Function|2
TRCINT|Trace Internal|2
TRCJOB|Trace Job|2
TRCREX|Trace REXX|2
TRCTCPAPP|Trace TCP/IP Application|2
TRCTCPRTE|Trace TCP/IP Packet Route|2
TRNCKMKSF|Translate Crytographic Key Management Keystore File|2
UNMOUNT|Remove Mounted File System|2
UPDDTA|Update Data with Temp Program|2
UPDPGM|Update Program|2
UPDPTFINF|Update PTF Information|2
UPDSRVPGM|Update Service Program|2
UPDSYSINF|Update System Information|2
UPDTCPINF|Update TCP/IP Information|2
VFYAPPCCNN|Verify APPC Connection|2
VFYCMN|Verify Communications|2
VFYIMGCLG|Verify Image Catalog|2
VFYLNKLPDA|Verify Link supporting LPDA-2|2
VFYMOVBRM|Verify Moves using BRMS|2
VFYOPCCNN|Verify OptiConnect Connections|2
VFYOPT|Verify Optical|2
VFYPRT|Verify Printer|2
VFYSRVAGT|Verify Service Agent|2
VFYSRVCFG|Verify Service Configuration|2
VFYTAP|Verify Tape|2
VFYTCPCNN|Verify TCP/IP Connection|2
VRYCFG|Vary Configuration|2
WAIT|Wait|2
WHEN|When|2
WRKACTJOB|Work with Active Jobs|2
WRKALR|Work with Alerts|2
WRKALRD|Work with Alert Descriptions|2
WRKALRTBL|Work with Alert Table|2
WRKAPPNSTS|Work with APPN Status|2
WRKARMJOB|Work with ARM Jobs|2
WRKASPBRM|Work with Auxiliary Storage Pool Descriptions|2
WRKASPCPYD|Work with ASP Copy Descriptions|2
WRKASPJOB|Work with Auxiliary Storage Pool Jobs|2
WRKAUT|Work with Authority|2
WRKAUTL|Work with Authorization Lists|2
WRKBNDDIR|Work with Binding Directories|2
WRKBNDDIRE|Work with Binding Directory Entries|2
WRKBPTBL|Work with BOOTP table|2
WRKCADMRE|Work with Cluster Administrative Domain Managed Resource Entries|2
WRKCALBRM|Work with Calendars using BRMS|2
WRKCFGL|Work with Configuration Lists|2
WRKCFGSTS|Work with Configuration Status|2
WRKCHTFMT|Work with Chart Formats|2
WRKCICSCVT|Work with CICS CVT|2
WRKCICSDCT|Work with CICS DCT|2
WRKCICSFCT|Work with CICS FCT|2
WRKCICSGLT|Work with CICS GLT|2
WRKCICSGRP|Work with CICS Group|2
WRKCICSJCT|Work with CICS JCT|2
WRKCICSPCT|Work with CICS PCT|2
WRKCICSPPT|Work with CICS PPT|2
WRKCICSSIT|Work with CICS SIT|2
WRKCICSSTS|Work CICS Status|2
WRKCICSTCS|Work with CICS TCS|2
WRKCICSTCT|Work with CICS TCT|2
WRKCICSTST|Work with CICS TST|2
WRKCLS|Work with Classes|2
WRKCLSBRM|Work with Classes using BRMS|2
WRKCLU|Work with Cluster|2
WRKCMD|Work with Commands|2
WRKCMTDFN|Work with Commitment Definitions|2
WRKCNNL|Work with Connection Lists|2
WRKCNRBRM|Work with Containers using BRMS|2
WRKCNTINF|Work with Contact Information|2
WRKCOSD|Work with COS Descriptions|2
WRKCRQD|Work with Change Request Descriptions|2
WRKCSI|Work with Communications Side Information|2
WRKCTLD|Work with Controller Descriptions|2
WRKCTLGBRM|Work with Control Groups|2
WRKDBFIDD|Work with Database Files using IDDU|2
WRKDDMF|Work with Distributed Data Management Files|2
WRKDEVBRM|Work with Devices using BRMS|2
WRKDEVD|Work with Device Descriptions|2
WRKDEVTBL|Work with Device Tables|2
WRKDIRE|Work with Directory Entries|2
WRKDIRLOC|Work with Directory Locations|2
WRKDIRSHD|Work with Directory Shadow Systems|2
WRKDOC|Work with Documents|2
WRKDOCLIB|Work with Document Libraries|2
WRKDOCPRTQ|Work with Document Print Queue|2
WRKDPCQ|Work with DSNX/PC Queues|2
WRKDSKSTS|Work with Disk Status|2
WRKDSTCLGE|Work with Distribution Catalog Entries|2
WRKDSTL|Work with Distribution Lists|2
WRKDSTQ|Work with Distribution Queue|2
WRKDTAARA|Work with Data Areas|2
WRKDTADCT|Work with Data Dictionaries|2
WRKDTADFN|Work with Data Definitions|2
WRKDTAQ|Work with Data Queues|2
WRKEDTD|Work with Edit Descriptions|2
WRKENVVAR|Work with Environment Variables|2
WRKF|Work with Files|2
WRKFCNARA|Work with Functional Areas|2
WRKFCNUSG|Work with Function Usage|2
WRKFCT|Work with Forms Control Table|2
WRKFLR|Work with Folders|2
WRKFLRBRM|Work with Saved Folders|2
WRKFNTRSC|Work with Font Resources|2
WRKFORMDF|Work with Form Definitions|2
WRKFTR|Work with Filters|2
WRKFTRACNE|Work with Filter Action Entry|2
WRKFTRSLTE|Work with Filter Selection Entry|2
WRKGSS|Work with Graphics Symbol Sets|2
WRKHACFGD|Work with HA Configuration Description) |2
WRKHDWPRD|Work with Hardware Products|2
WRKHDWRSC|Work with Hardware Resources|2
WRKHLDOPTF|Work with Held Optical Files|2
WRKHSTJS|Work with History using Advanced Job Scheduler|2
WRKHYSSTS|Work with HyperSwap Status) |2
WRKIMGCLG|Work with Image Catalogs|2
WRKIMGCLGE|Work with Image Catalog Entries|2
WRKIPXD|Work with IPX Descriptions|2
WRKJOB|Work with Job|2
WRKJOBD|Work with Job Descriptions|2
WRKJOBJS|Work with Jobs using Advanced Job Scheduler|2
WRKJOBLOG|Work with Job Logs|2
WRKJOBQ|Work with Job Queue|2
WRKJOBQD|Work with Job Queue Description|2
WRKJOBSCDE|Work with Job Schedule Entries|2
WRKJRN|Work with Journal|2
WRKJRNA|Work with Journal Attributes|2
WRKJRNRCV|Work with Journal Receivers|2
WRKJVMJOB|Work with Java Virtual Machine Jobs|2
WRKLANADPT|Work with LAN Adapters|2
WRKLBRM|Work with Lists using BRMS|2
WRKLIB|Work with Libraries|2
WRKLIBAMT|Work with Libraries using Application Management Toolset|2
WRKLIBPDM|Work with Libraries using Programming Development Manager|2
WRKLICINF|Work with License Information|2
WRKLIND|Work with Line Descriptions|2
WRKLNK|Work with Object Links|2
WRKLNKBRM|Work with Link Information|2
WRKLOCBRM|Work with Locations using BRMS|2
WRKMBRAMT|Work with Members using Application Management Toolset|2
WRKMBRPDM|Work with Members using Programming Development Manager|2
WRKMEDBRM|Work with Media using BRMS|2
WRKMEDIBRM|Work with Media Information|2
WRKMGRIBRM|Work with Migration Information|2
WRKMLBBRM|Work with Media Libraries|2
WRKMLBRSCQ|Work with Media Library Resource Queue|2
WRKMLBSTS|Work with Media Library Status|2
WRKMLMBRM|Work with Media Library Media|2
WRKMNU|Work with Menus|2
WRKMOD|Work with Modules|2
WRKMODD|Work with Mode Descriptions|2
WRKMSG|Work with Messages|2
WRKMSGD|Work with Message Descriptions|2
WRKMSGF|Work with Message Files|2
WRKMSGQ|Work with Message Queues|2
WRKNAMSMTP|Work with Names for SMTP|2
WRKNCK|Work with Nickname|2
WRKNETF|Work with Network Files|2
WRKNETJOBE|Work with Network Job Entries|2
WRKNETTBLE|Work with Network Table Entry|2
WRKNODL|Work with Node List|2
WRKNODLE|Work with Node List Entries|2
WRKNTBD|Work with NetBIOS Descriptions|2
WRKNWID|Work with Network Interfaces|2
WRKNWSCFG|Work with Network Server Configurations|2
WRKNWSD|Work with Network Servers|2
WRKNWSENR|Work with Network Server User Enrollment|2
WRKNWSSTG|Work with Network Server Storage Spaces|2
WRKNWSSTS|Work with Network Server Status|2
WRKOBJ|Work with Objects|2
WRKOBJAMT|Work with Objects using Application Management Toolset|2
WRKOBJBRM|Work with Saved Objects|2
WRKOBJLCK|Work with Object Locks|2
WRKOBJOWN|Work with Objects by Owner|2
WRKOBJPDM|Work with Objects using Programming Development Manager|2
WRKOBJPGP|Work with Objects by Primary Group|2
WRKOBJPVT|Work with Objects by Private Authority|2
WRKOPCACT|Work with OptiConnect Activity|2
WRKOPTDIR|Work with Optical Directories|2
WRKOPTF|Work with Optical Files|2
WRKOPTVOL|Work with Optical Volumes|2
WRKOUTQ|Work with Output Queue|2
WRKOUTQD|Work with Output Queue Descriptions|2
WRKOVL|Work with Overlays|2
WRKPAGDFN|Work with Page Definitions|2
WRKPAGSEG|Work with Page Segments|2
WRKPCLTBLE|Work with Protocol Table Entry|2
WRKPCYBRM|Work with Policies using BRMS|2
WRKPDFMAPE|Work with PDF Map Entries|2
WRKPEXDFN|Work with Performance Explorer Definitions|2
WRKPEXFTR|Work with Performance Explorer Filters|2
WRKPFCST|Work with Physical File Constraints|2
WRKPFDL|Work with Physical File DataLinks|2
WRKPGM|Work with Programs|2
WRKPGMTBL|Work with Program Tables|2
WRKPMRMTS|Work with Remote Systems|2
WRKPMRPTO|Work with Top Ten Omissions|2
WRKPMSCH|Work with Scheduled Jobs|2
WRKPNLGRP|Work with Panel Groups|2
WRKPRB|Work with Problems|2
WRKPRDINF|Work with Product Information|2
WRKPRTSTS|Work with Printing Status|2
WRKPSFCFG|Work with Print Services Facility Configuration|2
WRKPTF|Work with Program Temporary Fix|2
WRKPTFGRP|Work with Program Temporary Fix Groups|2
WRKPTFORD|Work with Program Temporary Fix Orders|2
WRKQMFORM|Work with Query Management Forms|2
WRKQMQRY|Work with Query Management Queries|2
WRKQRY|Work With Queries|2
WRKQST|Work with Questions|2
WRKRCVCRQA|Work with Received Change Request Activities|2
WRKRCYBRM|Work with Recovery Activities|2
WRKRDBDIRE|Work with Relational Database Directory Entry|2
WRKRDR|Work with Readers|2
WRKREGINF|Work with Registration Information|2
WRKRJESSN|Work with RJE Session|2
WRKRMTDFN|Work with Remote Definitions|2
WRKRPYLE|Work with Reply List Entries|2
WRKRTDCFG|Work with RouteD Configuration|2
WRKS36|Work with S/36 Configuration|2
WRKS36PGMA|Work with S/36 Program Attributes|2
WRKS36PRCA|Work with S/36 Procedure Attributes|2
WRKS36SRCA|Work with S/36 Source Attributes|2
WRKSAVFBRM|Work with Save Files|2
WRKSBMCRQ|Work with Submitted Change Requests|2
WRKSBMCRQA|Work with Submitted Change Request Activities|2
WRKSBMJOB|Work with Submitted Jobs|2
WRKSBS|Work with Subsystems|2
WRKSBSD|Work with Subsystem Description|2
WRKSBSJOB|Work with Subsystem Jobs|2
WRKSCHIDX|Work with Search Indexes|2
WRKSCHIDXE|Work with Search Index Entries|2
WRKSFWAGR|Work with Software Agreements|2
WRKSHRPOOL|Work with Shared Storage Pools|2
WRKSMTPEMM|Work with SMTP E-Mail Messages|2
WRKSMTPUSR|Work with All SMTP Users|2
WRKSOC|Work with Sphere of Control|2
WRKSPADCT|Work with Spelling Aid Dictionaries|2
WRKSPLF|Work with Spooled Files|2
WRKSPLFA|Work with Spooled File Attributes|2
WRKSPLFBRM|Work with Saved Spooled Files|2
WRKSPTPRD|Work with Supported Products|2
WRKSRVAGT|Work with Service Agent|2
WRKSRVPGM|Work with Service Program|2
WRKSRVPVD|Work with Service Providers|2
WRKSRVRQS|Work with Service Requesters|2
WRKSRVTBLE|Work with Service Table Entries|2
WRKSSND|Work with Session Description|2
WRKSYSACT|Work with System Activity|2
WRKSYSSTS|Work with System Status|2
WRKSYSVAL|Work with System Value|2
WRKTAPCTG|Work with Tape Cartridges|2
WRKTBL|Work with Tables|2
WRKTCPPTP|Work with Point-to-Point TCP/IP Profiles|2
WRKTCPSTS|Work with TCP/IP Network Status|2
WRKTIE|Work with TIE|2
WRKTIMZON|Work with Time Zone Descriptions|2
WRKTRC|Work with Traces|2
WRKUSRJOB|Work with User Jobs|2
WRKUSRPRF|Work with User Profiles|2
WRKUSRTBL|Work with User Tables|2
WRKWCH|Work with Watches|2
WRKWTR|Work with Writers|2